Winamax Poker - Tournament "Expresso" buyIn: 0€ + 1€ level: 0 - HandId: #482996281053020161-1-1425937904 - Holdem no limit (10/20) - 2015/03/09 21:51:44 UTC
Table: 'Expresso(112456335)#0' 3-max (real money) Seat #2 is the button
Seat 1: tc1591 (500)
Seat 2: ATP26 (500)
Seat 3: Dida8 (500)
*** ANTE/BLINDS ***
Dida8 posts small blind 10
tc1591 posts big blind 20
Dealt to tc1591 [Kd Qd]
*** PRE-FLOP *** 
ATP26 raises 20 to 40
Dida8 folds
tc1591 raises 70 to 110
ATP26 folds
tc1591 collected 160 from pot
*** SUMMARY ***
Total pot 160 | No rake
Seat 1: tc1591 (big blind) won 160


Winamax Poker - Tournament "Expresso" buyIn: 0€ + 1€ level: 0 - HandId: #482996281053020161-2-1425937935 - Holdem no limit (10/20) - 2015/03/09 21:52:15 UTC
Table: 'Expresso(112456335)#0' 3-max (real money) Seat #3 is the button
Seat 1: tc1591 (550)
Seat 2: ATP26 (460)
Seat 3: Dida8 (490)
*** ANTE/BLINDS ***
tc1591 posts small blind 10
ATP26 posts big blind 20
Dealt to tc1591 [2s 4d]
*** PRE-FLOP *** 
Dida8 folds
tc1591 calls 10
ATP26 checks
*** FLOP *** [Qd Jd 2d]
tc1591 bets 530 and is all-in
ATP26 calls 440 and is all-in
*** TURN *** [Qd Jd 2d][Qc]
*** RIVER *** [Qd Jd 2d Qc][Js]
*** SHOW DOWN ***
ATP26 shows [Qh 6c] (Full of Queens and Jacks)
tc1591 shows [2s 4d] (Two pairs : Queens and Jacks)
tc1591 collected 90 from side pot 1
ATP26 collected 920 from main pot
*** SUMMARY ***
Total pot 1010 | No rake
Board: [Qd Jd 2d Qc Js]
Seat 1: tc1591 (small blind) showed [2s 4d] and won 90 with Two pairs : Queens and Jacks
Seat 2: ATP26 (big blind) showed [Qh 6c] and won 920 with Full of Queens and Jacks


Winamax Poker - Tournament "Expresso" buyIn: 0€ + 1€ level: 0 - HandId: #482996281053020161-3-1425937963 - Holdem no limit (10/20) - 2015/03/09 21:52:43 UTC
Table: 'Expresso(112456335)#0' 3-max (real money) Seat #1 is the button
Seat 1: tc1591 (90)
Seat 2: ATP26 (920)
Seat 3: Dida8 (490)
*** ANTE/BLINDS ***
ATP26 posts small blind 10
Dida8 posts big blind 20
Dealt to tc1591 [7c 8d]
*** PRE-FLOP *** 
tc1591 raises 70 to 90 and is all-in
ATP26 folds
Dida8 calls 70
*** FLOP *** [Ts 8h 2d]
*** TURN *** [Ts 8h 2d][5c]
*** RIVER *** [Ts 8h 2d 5c][7d]
*** SHOW DOWN ***
Dida8 shows [Jh Td] (One pair : Tens)
tc1591 shows [7c 8d] (Two pairs : 8 and 7)
tc1591 collected 190 from pot
*** SUMMARY ***
Total pot 190 | No rake
Board: [Ts 8h 2d 5c 7d]
Seat 1: tc1591 (button) showed [7c 8d] and won 190 with Two pairs : 8 and 7
Seat 3: Dida8 (big blind) showed [Jh Td] and lost with One pair : Tens


Winamax Poker - Tournament "Expresso" buyIn: 0€ + 1€ level: 0 - HandId: #482996281053020161-4-1425937982 - Holdem no limit (10/20) - 2015/03/09 21:53:02 UTC
Table: 'Expresso(112456335)#0' 3-max (real money) Seat #2 is the button
Seat 1: tc1591 (190)
Seat 2: ATP26 (910)
Seat 3: Dida8 (400)
*** ANTE/BLINDS ***
Dida8 posts small blind 10
tc1591 posts big blind 20
Dealt to tc1591 [6h 3d]
*** PRE-FLOP *** 
ATP26 calls 20
Dida8 calls 10
tc1591 checks
*** FLOP *** [Qd 8d 6c]
Dida8 bets 20
tc1591 calls 20
ATP26 raises 70 to 90
Dida8 calls 70
tc1591 folds
*** TURN *** [Qd 8d 6c][9h]
Dida8 checks
ATP26 bets 170
Dida8 folds
ATP26 collected 430 from pot
*** SUMMARY ***
Total pot 430 | No rake
Board: [Qd 8d 6c 9h]
Seat 2: ATP26 (button) won 430


Winamax Poker - Tournament "Expresso" buyIn: 0€ + 1€ level: 0 - HandId: #482996281053020161-5-1425938041 - Holdem no limit (10/20) - 2015/03/09 21:54:01 UTC
Table: 'Expresso(112456335)#0' 3-max (real money) Seat #3 is the button
Seat 1: tc1591 (150)
Seat 2: ATP26 (1060)
Seat 3: Dida8 (290)
*** ANTE/BLINDS ***
tc1591 posts small blind 10
ATP26 posts big blind 20
Dealt to tc1591 [9h Kh]
*** PRE-FLOP *** 
Dida8 folds
tc1591 calls 10
ATP26 raises 100 to 120
tc1591 calls 100
*** FLOP *** [Qc Jd 6h]
tc1591 checks
ATP26 bets 20
tc1591 raises 10 to 30 and is all-in
ATP26 calls 10
*** TURN *** [Qc Jd 6h][4c]
*** RIVER *** [Qc Jd 6h 4c][2c]
*** SHOW DOWN ***
tc1591 shows [9h Kh] (High card : King)
ATP26 shows [6d 6c] (Trips of 6)
ATP26 collected 300 from pot
*** SUMMARY ***
Total pot 300 | No rake
Board: [Qc Jd 6h 4c 2c]
Seat 1: tc1591 (small blind) showed [9h Kh] and lost with High card : King
Seat 2: ATP26 (big blind) showed [6d 6c] and won 300 with Trips of 6


