Winamax Poker - CashGame - HandId: #7273226-513-1425938336 - Holdem no limit (0.01€/0.02€) - 2015/03/09 21:58:56 UTC
Table: 'Aix-la-Chapelle 03' 9-max (real money) Seat #9 is the button
Seat 1: Incognito 1 (1.99€)
Seat 2: tc1591 (0.80€)
Seat 3: Incognito 3 (6.29€)
Seat 4: Incognito 4 (2€)
Seat 5: Incognito 5 (2.18€)
Seat 6: Incognito 6 (1.81€)
Seat 7: Incognito 7 (2.07€)
Seat 8: Incognito 8 (2.03€)
Seat 9: Incognito 9 (1.58€)
*** ANTE/BLINDS ***
Incognito 3 posts small blind 0.01€
Incognito 4 posts big blind 0.02€
*** PRE-FLOP *** 
Incognito 5 folds
Incognito 6 folds
Incognito 9 folds
Incognito 3 raises 0.05€ to 0.07€
Incognito 4 calls 0.05€
*** FLOP *** [8h 7d Ad]
Incognito 3 bets 0.08€
Incognito 4 folds
Incognito 3 collected 0.21€ from pot
*** SUMMARY ***
Total pot 0.21€ | Rake 0.01€
Board: [8h 7d Ad]
Seat 3: Incognito 3 (small blind) won 0.21€


Winamax Poker - CashGame - HandId: #7273226-514-1425938380 - Holdem no limit (0.01€/0.02€) - 2015/03/09 21:59:40 UTC
Table: 'Aix-la-Chapelle 03' 9-max (real money) Seat #3 is the button
Seat 1: Incognito 1 (1.99€)
Seat 2: tc1591 (0.80€)
Seat 3: Incognito 3 (6.35€)
Seat 4: Incognito 4 (1.93€)
Seat 5: Incognito 5 (2.18€)
Seat 6: Incognito 6 (1.81€)
Seat 7: Incognito 7 (2.07€)
Seat 8: Incognito 8 (2.03€)
Seat 9: Incognito 9 (1.58€)
*** ANTE/BLINDS ***
Incognito 4 posts small blind 0.01€
Incognito 5 posts big blind 0.02€
*** PRE-FLOP *** 
Incognito 6 folds
Incognito 9 calls 0.02€
Incognito 3 folds
Incognito 4 raises 0.02€ to 0.04€
Incognito 5 folds
Incognito 9 calls 0.02€
*** FLOP *** [3c Js 4d]
Incognito 4 bets 0.02€
Incognito 9 calls 0.02€
*** TURN *** [3c Js 4d][6h]
Incognito 4 bets 0.07€
Incognito 9 calls 0.07€
*** RIVER *** [3c Js 4d 6h][5c]
Incognito 4 bets 0.28€
Incognito 9 calls 0.28€
*** SHOW DOWN ***
Incognito 4 shows [Jc Ks] (One pair : Jacks)
Incognito 9 shows [3s 4s] (Two pairs : 4 and 3)
Incognito 9 collected 0.79€ from pot
*** SUMMARY ***
Total pot 0.79€ | Rake 0.05€
Board: [3c Js 4d 6h 5c]
Seat 4: Incognito 4 (small blind) showed [Jc Ks] and lost with One pair : Jacks
Seat 9: Incognito 9 showed [3s 4s] and won 0.79€ with Two pairs : 4 and 3


Winamax Poker - CashGame - HandId: #7273226-515-1425938460 - Holdem no limit (0.01€/0.02€) - 2015/03/09 22:01:00 UTC
Table: 'Aix-la-Chapelle 03' 9-max (real money) Seat #4 is the button
Seat 2: tc1591 (0.80€)
Seat 3: Incognito 3 (6.35€)
Seat 4: Incognito 4 (1.52€)
Seat 5: Incognito 5 (2.16€)
Seat 6: Incognito 6 (1.81€)
Seat 7: Incognito 7 (2.07€)
Seat 8: Incognito 8 (2.03€)
Seat 9: Incognito 9 (1.96€)
*** ANTE/BLINDS ***
Incognito 5 posts small blind 0.01€
Incognito 6 posts big blind 0.02€
*** PRE-FLOP *** 
Incognito 9 folds
Incognito 3 folds
Incognito 4 raises 0.08€ to 0.10€
Incognito 5 folds
Incognito 6 calls 0.08€
*** FLOP *** [3d Qc 2c]
Incognito 6 checks
Incognito 4 bets 0.11€
Incognito 6 folds
Incognito 4 collected 0.31€ from pot
*** SUMMARY ***
Total pot 0.31€ | Rake 0.01€
Board: [3d Qc 2c]
Seat 4: Incognito 4 (button) won 0.31€


Winamax Poker - CashGame - HandId: #7273226-516-1425938492 - Holdem no limit (0.01€/0.02€) - 2015/03/09 22:01:32 UTC
Table: 'Aix-la-Chapelle 03' 9-max (real money) Seat #5 is the button
Seat 2: tc1591 (0.80€)
Seat 3: Incognito 3 (6.35€)
Seat 4: Incognito 4 (1.62€)
Seat 5: Incognito 5 (2.15€)
Seat 6: Incognito 6 (1.71€)
Seat 7: Incognito 7 (2.07€)
Seat 8: Incognito 8 (2.03€)
*** ANTE/BLINDS ***
Incognito 6 posts small blind 0.01€
Incognito 8 posts big blind 0.02€
*** PRE-FLOP *** 
Incognito 3 folds
Incognito 4 raises 0.04€ to 0.06€
Incognito 5 folds
Incognito 6 raises 0.04€ to 0.10€
Incognito 8 folds
Incognito 4 calls 0.04€
*** FLOP *** [Ts 6c 2h]
Incognito 6 bets 0.11€
Incognito 4 calls 0.11€
*** TURN *** [Ts 6c 2h][6s]
Incognito 6 checks
Incognito 4 checks
*** RIVER *** [Ts 6c 2h 6s][9h]
Incognito 6 bets 0.22€
Incognito 4 calls 0.22€
*** SHOW DOWN ***
Incognito 4 shows [Ah 5d] (One pair : 6)
Incognito 6 shows [Td Ad] (Two pairs : Tens and 6)
Incognito 6 collected 0.82€ from pot
*** SUMMARY ***
Total pot 0.82€ | Rake 0.06€
Board: [Ts 6c 2h 6s 9h]
Seat 4: Incognito 4 showed [Ah 5d] and lost with One pair : 6
Seat 6: Incognito 6 (small blind) showed [Td Ad] and won 0.82€ with Two pairs : Tens and 6


Winamax Poker - CashGame - HandId: #7273226-517-1425938550 - Holdem no limit (0.01€/0.02€) - 2015/03/09 22:02:30 UTC
Table: 'Aix-la-Chapelle 03' 9-max (real money) Seat #6 is the button
Seat 2: tc1591 (0.80€)
Seat 3: Incognito 3 (6.35€)
Seat 4: Incognito 4 (1.19€)
Seat 5: Incognito 5 (2.15€)
Seat 6: Incognito 6 (2.10€)
Seat 7: Incognito 7 (2.07€)
Seat 8: Incognito 8 (2.01€)
*** ANTE/BLINDS ***
Incognito 8 posts small blind 0.01€
tc1591 posts big blind 0.02€
Dealt to tc1591 [9s As]
*** PRE-FLOP *** 
Incognito 3 folds
Incognito 4 raises 1.17€ to 1.19€ and is all-in
Incognito 5 folds
Incognito 6 folds
Incognito 8 folds
tc1591 calls 0.78€ and is all-in
*** FLOP *** [Tc 3d 2c]
*** TURN *** [Tc 3d 2c][5h]
*** RIVER *** [Tc 3d 2c 5h][8c]
*** SHOW DOWN ***
tc1591 shows [9s As] (High card : Ace)
Incognito 4 shows [Ks Jc] (High card : King)
Incognito 4 collected 0.39€ from side pot 1
tc1591 collected 1.51€ from main pot
*** SUMMARY ***
Total pot 1.90€ | Rake 0.10€
Board: [Tc 3d 2c 5h 8c]
Seat 2: tc1591 (big blind) showed [9s As] and won 1.51€ with High card : Ace
Seat 4: Incognito 4 showed [Ks Jc] and won 0.39€ with High card : King


Winamax Poker - CashGame - HandId: #7273226-518-1425938583 - Holdem no limit (0.01€/0.02€) - 2015/03/09 22:03:03 UTC
Table: 'Aix-la-Chapelle 03' 9-max (real money) Seat #8 is the button
Seat 2: tc1591 (1.51€)
Seat 3: Incognito 3 (6.35€)
Seat 4: Incognito 4 (0.39€)
Seat 5: Incognito 5 (2.15€)
Seat 6: Incognito 6 (2.10€)
Seat 7: Incognito 7 (2.07€)
Seat 8: Incognito 8 (2€)
*** ANTE/BLINDS ***
tc1591 posts small blind 0.01€
Incognito 3 posts big blind 0.02€
Dealt to tc1591 [Kc 8d]
*** PRE-FLOP *** 
Incognito 4 calls 0.02€
Incognito 5 folds
Incognito 6 calls 0.02€
Incognito 8 folds
tc1591 calls 0.01€
Incognito 3 checks
*** FLOP *** [2d 2s Ks]
tc1591 checks
Incognito 3 checks
Incognito 4 bets 0.37€ and is all-in
Incognito 6 folds
tc1591 calls 0.37€
Incognito 3 folds
*** TURN *** [2d 2s Ks][7s]
*** RIVER *** [2d 2s Ks 7s][Qc]
*** SHOW DOWN ***
tc1591 shows [Kc 8d] (Two pairs : Kings and 2)
Incognito 4 shows [Qs 9s] (Flush King high)
Incognito 4 collected 0.77€ from pot
*** SUMMARY ***
Total pot 0.77€ | Rake 0.05€
Board: [2d 2s Ks 7s Qc]
Seat 2: tc1591 (small blind) showed [Kc 8d] and lost with Two pairs : Kings and 2
Seat 4: Incognito 4 showed [Qs 9s] and won 0.77€ with Flush King high


Winamax Poker - CashGame - HandId: #7273226-519-1425938677 - Holdem no limit (0.01€/0.02€) - 2015/03/09 22:04:37 UTC
Table: 'Aix-la-Chapelle 03' 9-max (real money) Seat #2 is the button
Seat 1: Incognito 1 (1.74€)
Seat 2: tc1591 (1.12€)
Seat 3: Incognito 3 (6.33€)
Seat 4: Incognito 4 (0.77€)
Seat 5: Incognito 5 (2.15€)
Seat 6: Incognito 6 (2.08€)
Seat 7: Incognito 7 (2.07€)
Seat 8: Incognito 8 (2€)
Seat 9: Incognito 9 (2€)
*** ANTE/BLINDS ***
Incognito 4 denies big blind
Incognito 3 posts small blind 0.01€
Incognito 5 posts big blind 0.02€
Incognito 9 posts big blind 0.02€ out of position
Incognito 1 posts big blind 0.02€ out of position
Dealt to tc1591 [Kd As]
*** PRE-FLOP *** 
Incognito 6 folds
Incognito 8 folds
Incognito 9 checks
Incognito 1 checks
tc1591 raises 1.10€ to 1.12€ and is all-in
Incognito 3 folds
Incognito 5 folds
Incognito 9 folds
Incognito 1 folds
tc1591 collected 1.19€ from pot
*** SUMMARY ***
Total pot 1.19€ | No rake
Seat 2: tc1591 (button) won 1.19€


Winamax Poker - CashGame - HandId: #7273226-520-1425938728 - Holdem no limit (0.01€/0.02€) - 2015/03/09 22:05:28 UTC
Table: 'Aix-la-Chapelle 03' 9-max (real money) Seat #3 is the button
Seat 1: Incognito 1 (1.72€)
Seat 2: tc1591 (1.19€)
Seat 3: Incognito 3 (6.32€)
Seat 4: Incognito 4 (2€)
Seat 5: Incognito 5 (2.13€)
Seat 6: Incognito 6 (2.08€)
Seat 7: Incognito 7 (2.07€)
Seat 8: Incognito 8 (2€)
Seat 9: Incognito 9 (1.98€)
*** ANTE/BLINDS ***
Incognito 5 posts small blind 0.01€
Incognito 6 posts big blind 0.02€
Dealt to tc1591 [3s Ks]
*** PRE-FLOP *** 
Incognito 8 folds
Incognito 9 folds
Incognito 1 calls 0.02€
tc1591 folds
Incognito 3 calls 0.02€
Incognito 5 folds
Incognito 6 checks
*** FLOP *** [8s 7s Ah]
Incognito 6 bets 0.02€
Incognito 1 calls 0.02€
Incognito 3 calls 0.02€
*** TURN *** [8s 7s Ah][Kd]
Incognito 6 bets 0.02€
Incognito 1 folds
Incognito 3 calls 0.02€
*** RIVER *** [8s 7s Ah Kd][3d]
Incognito 6 bets 0.09€
Incognito 3 folds
Incognito 6 collected 0.25€ from pot
*** SUMMARY ***
Total pot 0.25€ | Rake 0.01€
Board: [8s 7s Ah Kd 3d]
Seat 6: Incognito 6 (big blind) won 0.25€


Winamax Poker - CashGame - HandId: #7273226-521-1425938826 - Holdem no limit (0.01€/0.02€) - 2015/03/09 22:07:06 UTC
Table: 'Aix-la-Chapelle 03' 9-max (real money) Seat #5 is the button
Seat 1: Incognito 1 (1.68€)
Seat 2: tc1591 (1.19€)
Seat 3: Incognito 3 (6.26€)
Seat 4: Incognito 4 (2€)
Seat 5: Incognito 5 (2.12€)
Seat 6: Incognito 6 (2.18€)
Seat 7: Incognito 7 (2.07€)
Seat 8: Incognito 8 (2€)
*** ANTE/BLINDS ***
Incognito 6 posts small blind 0.01€
Incognito 7 posts big blind 0.02€
Dealt to tc1591 [Kc Ts]
*** PRE-FLOP *** 
Incognito 8 folds
Incognito 1 raises 0.06€ to 0.08€
tc1591 folds
Incognito 3 folds
Incognito 5 folds
Incognito 6 folds
Incognito 7 folds
Incognito 1 collected 0.11€ from pot
*** SUMMARY ***
Total pot 0.11€ | No rake
Seat 1: Incognito 1 won 0.11€


Winamax Poker - CashGame - HandId: #7273226-522-1425938863 - Holdem no limit (0.01€/0.02€) - 2015/03/09 22:07:43 UTC
Table: 'Aix-la-Chapelle 03' 9-max (real money) Seat #6 is the button
Seat 1: Incognito 1 (1.71€)
Seat 2: tc1591 (1.19€)
Seat 3: Incognito 3 (6.26€)
Seat 4: Incognito 4 (2€)
Seat 5: Incognito 5 (2.12€)
Seat 6: Incognito 6 (2.17€)
Seat 7: Incognito 7 (2.05€)
Seat 8: Incognito 8 (2€)
*** ANTE/BLINDS ***
Incognito 7 posts small blind 0.01€
Incognito 8 posts big blind 0.02€
Dealt to tc1591 [9c 7s]
*** PRE-FLOP *** 
Incognito 1 folds
tc1591 folds
Incognito 3 folds
Incognito 5 folds
Incognito 6 calls 0.02€
Incognito 7 calls 0.01€
Incognito 8 checks
*** FLOP *** [8h 8d 4c]
Incognito 7 checks
Incognito 8 checks
Incognito 6 bets 0.04€
Incognito 7 folds
Incognito 8 folds
Incognito 6 collected 0.10€ from pot
*** SUMMARY ***
Total pot 0.10€ | No rake
Board: [8h 8d 4c]
Seat 6: Incognito 6 (button) won 0.10€


Winamax Poker - CashGame - HandId: #7273226-523-1425938972 - Holdem no limit (0.01€/0.02€) - 2015/03/09 22:09:32 UTC
Table: 'Aix-la-Chapelle 03' 9-max (real money) Seat #7 is the button
Seat 1: Incognito 1 (1.71€)
Seat 2: tc1591 (1.19€)
Seat 3: Incognito 3 (6.26€)
Seat 4: Incognito 4 (2€)
Seat 5: Incognito 5 (2.12€)
Seat 6: Incognito 6 (2.21€)
Seat 7: Incognito 7 (2.03€)
Seat 8: Incognito 8 (2€)
*** ANTE/BLINDS ***
Incognito 8 posts small blind 0.01€
Incognito 1 posts big blind 0.02€
Dealt to tc1591 [2s 2h]
*** PRE-FLOP *** 
tc1591 calls 0.02€
Incognito 3 folds
Incognito 5 folds
Incognito 6 calls 0.02€
Incognito 7 folds
Incognito 8 raises 0.07€ to 0.09€
Incognito 1 calls 0.07€
tc1591 calls 0.07€
Incognito 6 calls 0.07€
*** FLOP *** [Jd 3h 5h]
Incognito 8 checks
Incognito 1 checks
tc1591 checks
Incognito 6 bets 0.18€
Incognito 8 folds
Incognito 1 folds
tc1591 folds
Incognito 6 collected 0.52€ from pot
*** SUMMARY ***
Total pot 0.52€ | Rake 0.02€
Board: [Jd 3h 5h]
Seat 6: Incognito 6 won 0.52€


Winamax Poker - CashGame - HandId: #7273226-524-1425939102 - Holdem no limit (0.01€/0.02€) - 2015/03/09 22:11:42 UTC
Table: 'Aix-la-Chapelle 03' 9-max (real money) Seat #8 is the button
Seat 1: Incognito 1 (1.62€)
Seat 2: tc1591 (1.10€)
Seat 3: Incognito 3 (6.26€)
Seat 4: Incognito 4 (2€)
Seat 5: Incognito 5 (2.12€)
Seat 6: Incognito 6 (2.46€)
Seat 7: Incognito 7 (2.03€)
Seat 8: Incognito 8 (2€)
Seat 9: Incognito 9 (2€)
*** ANTE/BLINDS ***
Incognito 1 posts small blind 0.01€
tc1591 posts big blind 0.02€
Dealt to tc1591 [2c 4h]
*** PRE-FLOP *** 
Incognito 3 folds
Incognito 5 folds
Incognito 6 calls 0.02€
Incognito 7 calls 0.02€
Incognito 8 calls 0.02€
Incognito 1 raises 0.10€ to 0.12€
tc1591 folds
Incognito 6 folds
Incognito 7 folds
Incognito 8 folds
Incognito 1 collected 0.20€ from pot
*** SUMMARY ***
Total pot 0.20€ | No rake
Seat 1: Incognito 1 (small blind) won 0.20€


Winamax Poker - CashGame - HandId: #7273226-525-1425939176 - Holdem no limit (0.01€/0.02€) - 2015/03/09 22:12:56 UTC
Table: 'Aix-la-Chapelle 03' 9-max (real money) Seat #1 is the button
Seat 1: Incognito 1 (1.70€)
Seat 2: tc1591 (1.08€)
Seat 3: Incognito 3 (6.26€)
Seat 4: Incognito 4 (2€)
Seat 5: Incognito 5 (2.12€)
Seat 6: Incognito 6 (2.44€)
Seat 7: Incognito 7 (2.01€)
Seat 8: Incognito 8 (2€)
Seat 9: Incognito 9 (2€)
*** ANTE/BLINDS ***
tc1591 posts small blind 0.01€
Incognito 3 posts big blind 0.02€
Incognito 9 posts big blind 0.02€ out of position
Dealt to tc1591 [Jh 8d]
*** PRE-FLOP *** 
Incognito 5 folds
Incognito 6 folds
Incognito 7 raises 0.05€ to 0.07€
Incognito 8 folds
Incognito 9 calls 0.05€
Incognito 1 calls 0.07€
tc1591 folds
Incognito 3 folds
*** FLOP *** [Js 9c 7c]
Incognito 7 checks
Incognito 9 checks
Incognito 1 bets 1.63€ and is all-in
Incognito 7 folds
Incognito 9 folds
Incognito 1 collected 1.85€ from pot
*** SUMMARY ***
Total pot 1.85€ | Rake 0.02€
Board: [Js 9c 7c]
Seat 1: Incognito 1 (button) won 1.85€


Winamax Poker - CashGame - HandId: #7273226-526-1425939259 - Holdem no limit (0.01€/0.02€) - 2015/03/09 22:14:19 UTC
Table: 'Aix-la-Chapelle 03' 9-max (real money) Seat #2 is the button
Seat 1: Incognito 1 (1.85€)
Seat 2: tc1591 (1.07€)
Seat 3: Incognito 3 (6.24€)
Seat 4: Incognito 4 (2€)
Seat 5: Incognito 5 (2.12€)
Seat 6: Incognito 6 (2.44€)
Seat 7: Incognito 7 (2€)
Seat 8: Incognito 8 (2€)
Seat 9: Incognito 9 (1.93€)
*** ANTE/BLINDS ***
Incognito 3 posts small blind 0.01€
Incognito 4 posts big blind 0.02€
Dealt to tc1591 [3s Kc]
*** PRE-FLOP *** 
Incognito 5 folds
Incognito 6 folds
Incognito 7 folds
Incognito 8 folds
Incognito 9 raises 0.04€ to 0.06€
Incognito 1 folds
tc1591 folds
Incognito 3 folds
Incognito 4 folds
Incognito 9 collected 0.09€ from pot
*** SUMMARY ***
Total pot 0.09€ | No rake
Seat 9: Incognito 9 won 0.09€


Winamax Poker - CashGame - HandId: #7273226-527-1425939323 - Holdem no limit (0.01€/0.02€) - 2015/03/09 22:15:23 UTC
Table: 'Aix-la-Chapelle 03' 9-max (real money) Seat #3 is the button
Seat 1: Incognito 1 (1.85€)
Seat 2: tc1591 (1.07€)
Seat 3: Incognito 3 (6.23€)
Seat 4: Incognito 4 (2€)
Seat 5: Incognito 5 (2.12€)
Seat 6: Incognito 6 (2.44€)
Seat 7: Incognito 7 (2€)
Seat 8: Incognito 8 (2€)
Seat 9: Incognito 9 (1.96€)
*** ANTE/BLINDS ***
Incognito 4 posts small blind 0.01€
Incognito 5 posts big blind 0.02€
Dealt to tc1591 [5c Jh]
*** PRE-FLOP *** 
Incognito 6 folds
Incognito 7 folds
Incognito 8 folds
Incognito 9 raises 0.04€ to 0.06€
Incognito 1 raises 0.12€ to 0.18€
tc1591 folds
Incognito 3 folds
Incognito 4 folds
Incognito 5 folds
Incognito 9 calls 0.12€
*** FLOP *** [7s 2d 4h]
Incognito 9 checks
Incognito 1 bets 1.67€ and is all-in
Incognito 9 folds
Incognito 1 collected 2.03€ from pot
*** SUMMARY ***
Total pot 2.03€ | Rake 0.03€
Board: [7s 2d 4h]
Seat 1: Incognito 1 won 2.03€


Winamax Poker - CashGame - HandId: #7273226-528-1425939443 - Holdem no limit (0.01€/0.02€) - 2015/03/09 22:17:23 UTC
Table: 'Aix-la-Chapelle 03' 9-max (real money) Seat #4 is the button
Seat 1: Incognito 1 (2.03€)
Seat 2: tc1591 (1.07€)
Seat 3: Incognito 3 (6.23€)
Seat 4: Incognito 4 (2€)
Seat 5: Incognito 5 (2.10€)
Seat 6: Incognito 6 (2.44€)
Seat 7: Incognito 7 (2€)
Seat 8: Incognito 8 (2€)
Seat 9: Incognito 9 (1.78€)
*** ANTE/BLINDS ***
Incognito 5 posts small blind 0.01€
Incognito 6 posts big blind 0.02€
Dealt to tc1591 [Td 5c]
*** PRE-FLOP *** 
Incognito 7 folds
Incognito 8 raises 0.05€ to 0.07€
Incognito 9 folds
Incognito 1 calls 0.07€
tc1591 folds
Incognito 3 folds
Incognito 4 folds
Incognito 5 calls 0.06€
Incognito 6 folds
*** FLOP *** [9c Qh 5s]
Incognito 5 checks
Incognito 8 checks
Incognito 1 checks
*** TURN *** [9c Qh 5s][8s]
Incognito 5 bets 0.17€
Incognito 8 folds
Incognito 1 calls 0.17€
*** RIVER *** [9c Qh 5s 8s][6d]
Incognito 5 bets 0.38€
Incognito 1 raises 0.38€ to 0.76€
Incognito 5 folds
Incognito 1 collected 1.62€ from pot
*** SUMMARY ***
Total pot 1.62€ | Rake 0.09€
Board: [9c Qh 5s 8s 6d]
Seat 1: Incognito 1 won 1.62€


