Winamax Poker - Tournament "No Limit Hold'em" buyIn: 0,45€ + 0,05€ level: 0 - HandId: #445588443049754625-1-1418852857 - Holdem no limit (10/20) - 2014/12/17 21:47:37 UTC
Table: 'No Limit Hold'em(103746644)#0' 10-max (real money) Seat #8 is the button
Seat 1: rosti900 (1500)
Seat 2: molo_molo (1500)
Seat 3: saeba_xyz (1500)
Seat 4: x-lolilol (1500)
Seat 5: doopy00 (1500)
Seat 6: sabre_laser (1500)
Seat 7: Costals (1500)
Seat 8: Franz1317 (1500)
Seat 9: thiga69 (1500)
Seat 10: ChuckAldi (1500)
*** ANTE/BLINDS ***
thiga69 posts small blind 10
ChuckAldi posts big blind 20
Dealt to sabre_laser [As 4c]
*** PRE-FLOP *** 
rosti900 calls 20
molo_molo folds
saeba_xyz calls 20
x-lolilol folds
doopy00 folds
sabre_laser folds
Costals folds
Franz1317 folds
thiga69 calls 10
ChuckAldi checks
*** FLOP *** [6h Kc Ks]
thiga69 checks
ChuckAldi bets 40
rosti900 calls 40
saeba_xyz folds
thiga69 folds
*** TURN *** [6h Kc Ks][Js]
ChuckAldi bets 90
rosti900 raises 170 to 260
ChuckAldi raises 320 to 580
rosti900 raises 860 to 1440 and is all-in
ChuckAldi calls 860 and is all-in
*** RIVER *** [6h Kc Ks Js][5c]
*** SHOW DOWN ***
ChuckAldi shows [3s Kd] (Trips of Kings)
rosti900 shows [Kh Qs] (Trips of Kings)
rosti900 collected 3040 from pot
*** SUMMARY ***
Total pot 3040 | No rake
Board: [6h Kc Ks Js 5c]
Seat 1: rosti900 showed [Kh Qs] and won 3040 with Trips of Kings
Seat 10: ChuckAldi (big blind) showed [3s Kd] and lost with Trips of Kings


Winamax Poker - Tournament "No Limit Hold'em" buyIn: 0,45€ + 0,05€ level: 0 - HandId: #445588443049754625-2-1418853017 - Holdem no limit (10/20) - 2014/12/17 21:50:17 UTC
Table: 'No Limit Hold'em(103746644)#0' 10-max (real money) Seat #9 is the button
Seat 1: rosti900 (3040)
Seat 2: molo_molo (1500)
Seat 3: saeba_xyz (1480)
Seat 4: x-lolilol (1500)
Seat 5: doopy00 (1500)
Seat 6: sabre_laser (1500)
Seat 7: Costals (1500)
Seat 8: Franz1317 (1500)
Seat 9: thiga69 (1480)
*** ANTE/BLINDS ***
rosti900 posts big blind 20
Dealt to sabre_laser [6d 6c]
*** PRE-FLOP *** 
molo_molo folds
saeba_xyz folds
x-lolilol folds
doopy00 folds
sabre_laser raises 40 to 60
Costals folds
Franz1317 folds
thiga69 folds
rosti900 calls 40
*** FLOP *** [5c 9h Td]
rosti900 checks
sabre_laser checks
*** TURN *** [5c 9h Td][7c]
rosti900 checks
sabre_laser bets 120
rosti900 folds
sabre_laser collected 240 from pot
*** SUMMARY ***
Total pot 240 | No rake
Board: [5c 9h Td 7c]
Seat 6: sabre_laser won 240


Winamax Poker - Tournament "No Limit Hold'em" buyIn: 0,45€ + 0,05€ level: 0 - HandId: #445588443049754625-3-1418853122 - Holdem no limit (10/20) - 2014/12/17 21:52:02 UTC
Table: 'No Limit Hold'em(103746644)#0' 10-max (real money) Seat #10 is the button
Seat 1: rosti900 (2980)
Seat 2: molo_molo (1500)
Seat 3: saeba_xyz (1480)
Seat 4: x-lolilol (1500)
Seat 5: doopy00 (1500)
Seat 6: sabre_laser (1560)
Seat 7: Costals (1500)
Seat 8: Franz1317 (1500)
Seat 9: thiga69 (1480)
*** ANTE/BLINDS ***
rosti900 posts small blind 10
molo_molo posts big blind 20
Dealt to sabre_laser [5c Ks]
*** PRE-FLOP *** 
saeba_xyz folds
x-lolilol folds
doopy00 folds
sabre_laser folds
Costals folds
Franz1317 folds
thiga69 folds
rosti900 calls 10
molo_molo checks
*** FLOP *** [Ad 6h 7s]
rosti900 checks
molo_molo checks
*** TURN *** [Ad 6h 7s][Kc]
rosti900 checks
molo_molo checks
*** RIVER *** [Ad 6h 7s Kc][Qd]
rosti900 checks
molo_molo checks
*** SHOW DOWN ***
rosti900 shows [8s 4s] (High card : Ace)
molo_molo shows [2s 9h] (High card : Ace)
molo_molo collected 40 from pot
*** SUMMARY ***
Total pot 40 | No rake
Board: [Ad 6h 7s Kc Qd]
Seat 1: rosti900 (small blind) showed [8s 4s] and lost with High card : Ace
Seat 2: molo_molo (big blind) showed [2s 9h] and won 40 with High card : Ace


Winamax Poker - Tournament "No Limit Hold'em" buyIn: 0,45€ + 0,05€ level: 0 - HandId: #445588443049754625-4-1418853195 - Holdem no limit (10/20) - 2014/12/17 21:53:15 UTC
Table: 'No Limit Hold'em(103746644)#0' 10-max (real money) Seat #1 is the button
Seat 1: rosti900 (2960)
Seat 2: molo_molo (1520)
Seat 3: saeba_xyz (1480)
Seat 4: x-lolilol (1500)
Seat 5: doopy00 (1500)
Seat 6: sabre_laser (1560)
Seat 7: Costals (1500)
Seat 8: Franz1317 (1500)
Seat 9: thiga69 (1480)
*** ANTE/BLINDS ***
molo_molo posts small blind 10
saeba_xyz posts big blind 20
Dealt to sabre_laser [Ts 3h]
*** PRE-FLOP *** 
x-lolilol folds
doopy00 folds
sabre_laser folds
Costals folds
Franz1317 folds
thiga69 calls 20
rosti900 folds
molo_molo folds
saeba_xyz checks
*** FLOP *** [7h Jh 3c]
saeba_xyz checks
thiga69 checks
*** TURN *** [7h Jh 3c][2h]
saeba_xyz checks
thiga69 checks
*** RIVER *** [7h Jh 3c 2h][Ad]
saeba_xyz checks
thiga69 checks
*** SHOW DOWN ***
thiga69 shows [6d 5d] (High card : Ace)
saeba_xyz shows [9d 4d] (High card : Ace)
saeba_xyz collected 50 from pot
*** SUMMARY ***
Total pot 50 | No rake
Board: [7h Jh 3c 2h Ad]
Seat 3: saeba_xyz (big blind) showed [9d 4d] and won 50 with High card : Ace
Seat 9: thiga69 showed [6d 5d] and lost with High card : Ace


Winamax Poker - Tournament "No Limit Hold'em" buyIn: 0,45€ + 0,05€ level: 0 - HandId: #445588443049754625-5-1418853309 - Holdem no limit (10/20) - 2014/12/17 21:55:09 UTC
Table: 'No Limit Hold'em(103746644)#0' 10-max (real money) Seat #2 is the button
Seat 1: rosti900 (2960)
Seat 2: molo_molo (1510)
Seat 3: saeba_xyz (1510)
Seat 4: x-lolilol (1500)
Seat 5: doopy00 (1500)
Seat 6: sabre_laser (1560)
Seat 7: Costals (1500)
Seat 8: Franz1317 (1500)
Seat 9: thiga69 (1460)
*** ANTE/BLINDS ***
saeba_xyz posts small blind 10
x-lolilol posts big blind 20
Dealt to sabre_laser [5s Qc]
*** PRE-FLOP *** 
doopy00 folds
sabre_laser folds
Costals folds
Franz1317 folds
thiga69 calls 20
rosti900 folds
molo_molo folds
saeba_xyz calls 10
x-lolilol checks
*** FLOP *** [8c Js 7h]
saeba_xyz bets 30
x-lolilol folds
thiga69 calls 30
*** TURN *** [8c Js 7h][5c]
saeba_xyz bets 60
thiga69 calls 60
*** RIVER *** [8c Js 7h 5c][Kd]
saeba_xyz checks
thiga69 bets 120
saeba_xyz folds
thiga69 collected 360 from pot
*** SUMMARY ***
Total pot 360 | No rake
Board: [8c Js 7h 5c Kd]
Seat 9: thiga69 won 360


Winamax Poker - Tournament "No Limit Hold'em" buyIn: 0,45€ + 0,05€ level: 1 - HandId: #445588443049754625-6-1418853437 - Holdem no limit (15/30) - 2014/12/17 21:57:17 UTC
Table: 'No Limit Hold'em(103746644)#0' 10-max (real money) Seat #3 is the button
Seat 1: rosti900 (2960)
Seat 2: molo_molo (1510)
Seat 3: saeba_xyz (1400)
Seat 4: x-lolilol (1480)
Seat 5: doopy00 (1500)
Seat 6: sabre_laser (1560)
Seat 7: Costals (1500)
Seat 8: Franz1317 (1500)
Seat 9: thiga69 (1590)
*** ANTE/BLINDS ***
x-lolilol posts small blind 15
doopy00 posts big blind 30
Dealt to sabre_laser [Jh 5c]
*** PRE-FLOP *** 
sabre_laser folds
Costals folds
Franz1317 folds
thiga69 calls 30
rosti900 folds
molo_molo folds
saeba_xyz calls 30
x-lolilol folds
doopy00 checks
*** FLOP *** [3d Kh Ad]
doopy00 checks
thiga69 bets 30
saeba_xyz raises 83 to 113
doopy00 folds
thiga69 calls 83
*** TURN *** [3d Kh Ad][8s]
thiga69 checks
saeba_xyz bets 166
thiga69 folds
saeba_xyz collected 497 from pot
*** SUMMARY ***
Total pot 497 | No rake
Board: [3d Kh Ad 8s]
Seat 3: saeba_xyz (button) won 497


Winamax Poker - Tournament "No Limit Hold'em" buyIn: 0,45€ + 0,05€ level: 1 - HandId: #445588443049754625-7-1418853508 - Holdem no limit (15/30) - 2014/12/17 21:58:28 UTC
Table: 'No Limit Hold'em(103746644)#0' 10-max (real money) Seat #4 is the button
Seat 1: rosti900 (2960)
Seat 2: molo_molo (1510)
Seat 3: saeba_xyz (1588)
Seat 4: x-lolilol (1465)
Seat 5: doopy00 (1470)
Seat 6: sabre_laser (1560)
Seat 7: Costals (1500)
Seat 8: Franz1317 (1500)
Seat 9: thiga69 (1447)
*** ANTE/BLINDS ***
doopy00 posts small blind 15
sabre_laser posts big blind 30
Dealt to sabre_laser [Tc 3d]
*** PRE-FLOP *** 
Costals folds
Franz1317 folds
thiga69 calls 30
rosti900 calls 30
molo_molo folds
saeba_xyz raises 120 to 150
x-lolilol folds
doopy00 folds
sabre_laser folds
thiga69 calls 120
rosti900 calls 120
*** FLOP *** [4d 8c 5h]
thiga69 checks
rosti900 checks
saeba_xyz bets 495
thiga69 folds
rosti900 folds
saeba_xyz collected 990 from pot
*** SUMMARY ***
Total pot 990 | No rake
Board: [4d 8c 5h]
Seat 3: saeba_xyz won 990


Winamax Poker - Tournament "No Limit Hold'em" buyIn: 0,45€ + 0,05€ level: 1 - HandId: #445588443049754625-8-1418853601 - Holdem no limit (15/30) - 2014/12/17 22:00:01 UTC
Table: 'No Limit Hold'em(103746644)#0' 10-max (real money) Seat #5 is the button
Seat 1: rosti900 (2810)
Seat 2: molo_molo (1510)
Seat 3: saeba_xyz (1933)
Seat 4: x-lolilol (1465)
Seat 5: doopy00 (1455)
Seat 6: sabre_laser (1530)
Seat 7: Costals (1500)
Seat 8: Franz1317 (1500)
Seat 9: thiga69 (1297)
*** ANTE/BLINDS ***
sabre_laser posts small blind 15
Costals posts big blind 30
Dealt to sabre_laser [6c As]
*** PRE-FLOP *** 
Franz1317 folds
thiga69 folds
rosti900 folds
molo_molo raises 45 to 75
saeba_xyz folds
x-lolilol folds
doopy00 folds
sabre_laser calls 60
Costals folds
*** FLOP *** [Js 6d Kc]
sabre_laser checks
molo_molo bets 90
sabre_laser raises 195 to 285
molo_molo folds
sabre_laser collected 555 from pot
*** SUMMARY ***
Total pot 555 | No rake
Board: [Js 6d Kc]
Seat 6: sabre_laser (small blind) won 555


Winamax Poker - Tournament "No Limit Hold'em" buyIn: 0,45€ + 0,05€ level: 1 - HandId: #445588443049754625-9-1418853763 - Holdem no limit (15/30) - 2014/12/17 22:02:43 UTC
Table: 'No Limit Hold'em(103746644)#0' 10-max (real money) Seat #6 is the button
Seat 1: rosti900 (2810)
Seat 2: molo_molo (1345)
Seat 3: saeba_xyz (1933)
Seat 4: x-lolilol (1465)
Seat 5: doopy00 (1455)
Seat 6: sabre_laser (1725)
Seat 7: Costals (1470)
Seat 8: Franz1317 (1500)
Seat 9: thiga69 (1297)
*** ANTE/BLINDS ***
Costals posts small blind 15
Franz1317 posts big blind 30
Dealt to sabre_laser [Qd Qs]
*** PRE-FLOP *** 
thiga69 calls 30
rosti900 folds
molo_molo folds
saeba_xyz folds
x-lolilol folds
doopy00 folds
sabre_laser raises 90 to 120
Costals raises 165 to 285
Franz1317 folds
thiga69 folds
sabre_laser raises 1440 to 1725 and is all-in
Costals calls 1185 and is all-in
*** FLOP *** [Kd 8s Jd]
*** TURN *** [Kd 8s Jd][3d]
*** RIVER *** [Kd 8s Jd 3d][4d]
*** SHOW DOWN ***
Costals shows [Tc Th] (One pair : Tens)
sabre_laser shows [Qd Qs] (Flush King high)
sabre_laser collected 3255 from pot
*** SUMMARY ***
Total pot 3255 | No rake
Board: [Kd 8s Jd 3d 4d]
Seat 6: sabre_laser (button) showed [Qd Qs] and won 3255 with Flush King high
Seat 7: Costals (small blind) showed [Tc Th] and lost with One pair : Tens


Winamax Poker - Tournament "No Limit Hold'em" buyIn: 0,45€ + 0,05€ level: 2 - HandId: #445588443049754625-10-1418853921 - Holdem no limit (20/40) - 2014/12/17 22:05:21 UTC
Table: 'No Limit Hold'em(103746644)#0' 10-max (real money) Seat #7 is the button
Seat 1: rosti900 (2810)
Seat 2: molo_molo (1345)
Seat 3: saeba_xyz (1933)
Seat 4: x-lolilol (1465)
Seat 5: doopy00 (1455)
Seat 6: sabre_laser (3255)
Seat 8: Franz1317 (1470)
Seat 9: thiga69 (1267)
*** ANTE/BLINDS ***
Franz1317 posts small blind 20
thiga69 posts big blind 40
Dealt to sabre_laser [8d Kd]
*** PRE-FLOP *** 
rosti900 folds
molo_molo folds
saeba_xyz calls 40
x-lolilol folds
doopy00 calls 40
sabre_laser calls 40
Franz1317 folds
thiga69 checks
*** FLOP *** [Jh Kc 6c]
thiga69 checks
saeba_xyz checks
doopy00 checks
sabre_laser bets 180
thiga69 calls 180
saeba_xyz folds
doopy00 folds
*** TURN *** [Jh Kc 6c][Ks]
thiga69 checks
sabre_laser checks
*** RIVER *** [Jh Kc 6c Ks][4s]
thiga69 bets 270
sabre_laser calls 270
*** SHOW DOWN ***
thiga69 shows [Qh Ac] (One pair : Kings)
sabre_laser shows [8d Kd] (Trips of Kings)
sabre_laser collected 1080 from pot
*** SUMMARY ***
Total pot 1080 | No rake
Board: [Jh Kc 6c Ks 4s]
Seat 6: sabre_laser showed [8d Kd] and won 1080 with Trips of Kings
Seat 9: thiga69 (big blind) showed [Qh Ac] and lost with One pair : Kings


Winamax Poker - Tournament "No Limit Hold'em" buyIn: 0,45€ + 0,05€ level: 2 - HandId: #445588443049754625-11-1418854057 - Holdem no limit (20/40) - 2014/12/17 22:07:37 UTC
Table: 'No Limit Hold'em(103746644)#0' 10-max (real money) Seat #8 is the button
Seat 1: rosti900 (2810)
Seat 2: molo_molo (1345)
Seat 3: saeba_xyz (1893)
Seat 4: x-lolilol (1465)
Seat 5: doopy00 (1415)
Seat 6: sabre_laser (3845)
Seat 8: Franz1317 (1450)
Seat 9: thiga69 (777)
*** ANTE/BLINDS ***
thiga69 posts small blind 20
rosti900 posts big blind 40
Dealt to sabre_laser [6d Kh]
*** PRE-FLOP *** 
molo_molo folds
saeba_xyz folds
x-lolilol folds
doopy00 folds
sabre_laser folds
Franz1317 folds
thiga69 calls 20
rosti900 checks
*** FLOP *** [Jc 2d Kd]
thiga69 checks
rosti900 bets 240
thiga69 folds
rosti900 collected 320 from pot
*** SUMMARY ***
Total pot 320 | No rake
Board: [Jc 2d Kd]
Seat 1: rosti900 (big blind) won 320


Winamax Poker - Tournament "No Limit Hold'em" buyIn: 0,45€ + 0,05€ level: 2 - HandId: #445588443049754625-12-1418854099 - Holdem no limit (20/40) - 2014/12/17 22:08:19 UTC
Table: 'No Limit Hold'em(103746644)#0' 10-max (real money) Seat #9 is the button
Seat 1: rosti900 (2850)
Seat 2: molo_molo (1345)
Seat 3: saeba_xyz (1893)
Seat 4: x-lolilol (1465)
Seat 5: doopy00 (1415)
Seat 6: sabre_laser (3845)
Seat 8: Franz1317 (1450)
Seat 9: thiga69 (737)
*** ANTE/BLINDS ***
rosti900 posts small blind 20
molo_molo posts big blind 40
Dealt to sabre_laser [Jh 6h]
*** PRE-FLOP *** 
saeba_xyz calls 40
x-lolilol raises 160 to 200
doopy00 folds
sabre_laser folds
Franz1317 folds
thiga69 folds
rosti900 calls 180
molo_molo folds
saeba_xyz folds
*** FLOP *** [4s 2c 4c]
rosti900 checks
x-lolilol bets 260
rosti900 folds
x-lolilol collected 740 from pot
*** SUMMARY ***
Total pot 740 | No rake
Board: [4s 2c 4c]
Seat 4: x-lolilol won 740


Winamax Poker - Tournament "No Limit Hold'em" buyIn: 0,45€ + 0,05€ level: 2 - HandId: #445588443049754625-13-1418854161 - Holdem no limit (20/40) - 2014/12/17 22:09:21 UTC
Table: 'No Limit Hold'em(103746644)#0' 10-max (real money) Seat #1 is the button
Seat 1: rosti900 (2650)
Seat 2: molo_molo (1305)
Seat 3: saeba_xyz (1853)
Seat 4: x-lolilol (1745)
Seat 5: doopy00 (1415)
Seat 6: sabre_laser (3845)
Seat 8: Franz1317 (1450)
Seat 9: thiga69 (737)
*** ANTE/BLINDS ***
molo_molo posts small blind 20
saeba_xyz posts big blind 40
Dealt to sabre_laser [6c 3h]
*** PRE-FLOP *** 
x-lolilol folds
doopy00 folds
sabre_laser folds
Franz1317 folds
thiga69 raises 80 to 120
rosti900 folds
molo_molo folds
saeba_xyz folds
thiga69 collected 180 from pot
*** SUMMARY ***
Total pot 180 | No rake
Seat 9: thiga69 won 180


Winamax Poker - Tournament "No Limit Hold'em" buyIn: 0,45€ + 0,05€ level: 2 - HandId: #445588443049754625-14-1418854196 - Holdem no limit (20/40) - 2014/12/17 22:09:56 UTC
Table: 'No Limit Hold'em(103746644)#0' 10-max (real money) Seat #2 is the button
Seat 1: rosti900 (2650)
Seat 2: molo_molo (1285)
Seat 3: saeba_xyz (1813)
Seat 4: x-lolilol (1745)
Seat 5: doopy00 (1415)
Seat 6: sabre_laser (3845)
Seat 8: Franz1317 (1450)
Seat 9: thiga69 (797)
*** ANTE/BLINDS ***
saeba_xyz posts small blind 20
x-lolilol posts big blind 40
Dealt to sabre_laser [6h Kd]
*** PRE-FLOP *** 
doopy00 folds
sabre_laser folds
Franz1317 folds
thiga69 folds
rosti900 folds
molo_molo folds
saeba_xyz folds
x-lolilol collected 60 from pot
*** SUMMARY ***
Total pot 60 | No rake
Seat 4: x-lolilol (big blind) won 60


Winamax Poker - Tournament "No Limit Hold'em" buyIn: 0,45€ + 0,05€ level: 2 - HandId: #445588443049754625-15-1418854225 - Holdem no limit (20/40) - 2014/12/17 22:10:25 UTC
Table: 'No Limit Hold'em(103746644)#0' 10-max (real money) Seat #3 is the button
Seat 1: rosti900 (2650)
Seat 2: molo_molo (1285)
Seat 3: saeba_xyz (1793)
Seat 4: x-lolilol (1765)
Seat 5: doopy00 (1415)
Seat 6: sabre_laser (3845)
Seat 8: Franz1317 (1450)
Seat 9: thiga69 (797)
*** ANTE/BLINDS ***
x-lolilol posts small blind 20
doopy00 posts big blind 40
Dealt to sabre_laser [9h Qs]
*** PRE-FLOP *** 
sabre_laser folds
Franz1317 folds
thiga69 folds
rosti900 folds
molo_molo folds
saeba_xyz folds
x-lolilol folds
doopy00 collected 60 from pot
*** SUMMARY ***
Total pot 60 | No rake
Seat 5: doopy00 (big blind) won 60


Winamax Poker - Tournament "No Limit Hold'em" buyIn: 0,45€ + 0,05€ level: 2 - HandId: #445588443049754625-16-1418854263 - Holdem no limit (20/40) - 2014/12/17 22:11:03 UTC
Table: 'No Limit Hold'em(103746644)#0' 10-max (real money) Seat #4 is the button
Seat 1: rosti900 (2650)
Seat 2: molo_molo (1285)
Seat 3: saeba_xyz (1793)
Seat 4: x-lolilol (1745)
Seat 5: doopy00 (1435)
Seat 6: sabre_laser (3845)
Seat 8: Franz1317 (1450)
Seat 9: thiga69 (797)
*** ANTE/BLINDS ***
doopy00 posts small blind 20
sabre_laser posts big blind 40
Dealt to sabre_laser [2s As]
*** PRE-FLOP *** 
Franz1317 folds
thiga69 folds
rosti900 folds
molo_molo folds
saeba_xyz folds
x-lolilol folds
doopy00 calls 20
sabre_laser checks
*** FLOP *** [5c Ah Kh]
doopy00 checks
sabre_laser bets 80
doopy00 calls 80
*** TURN *** [5c Ah Kh][Ks]
doopy00 checks
sabre_laser checks
*** RIVER *** [5c Ah Kh Ks][8s]
doopy00 bets 120
sabre_laser folds
doopy00 collected 360 from pot
*** SUMMARY ***
Total pot 360 | No rake
Board: [5c Ah Kh Ks 8s]
Seat 5: doopy00 (small blind) won 360


Winamax Poker - Tournament "No Limit Hold'em" buyIn: 0,45€ + 0,05€ level: 3 - HandId: #445588443049754625-17-1418854444 - Holdem no limit (30/60) - 2014/12/17 22:14:04 UTC
Table: 'No Limit Hold'em(103746644)#0' 10-max (real money) Seat #5 is the button
Seat 1: rosti900 (2650)
Seat 2: molo_molo (1285)
Seat 3: saeba_xyz (1793)
Seat 4: x-lolilol (1745)
Seat 5: doopy00 (1555)
Seat 6: sabre_laser (3725)
Seat 8: Franz1317 (1450)
Seat 9: thiga69 (797)
*** ANTE/BLINDS ***
sabre_laser posts small blind 30
Franz1317 posts big blind 60
Dealt to sabre_laser [Tc 5h]
*** PRE-FLOP *** 
thiga69 folds
rosti900 folds
molo_molo folds
saeba_xyz folds
x-lolilol folds
doopy00 calls 60
sabre_laser calls 30
Franz1317 checks
*** FLOP *** [Kd 2d 5c]
sabre_laser bets 150
Franz1317 calls 150
doopy00 calls 150
*** TURN *** [Kd 2d 5c][2c]
sabre_laser bets 315
Franz1317 calls 315
doopy00 folds
*** RIVER *** [Kd 2d 5c 2c][4d]
sabre_laser checks
Franz1317 checks
*** SHOW DOWN ***
sabre_laser shows [Tc 5h] (Two pairs : 5 and 2)
Franz1317 shows [Th Kh] (Two pairs : Kings and 2)
Franz1317 collected 1260 from pot
*** SUMMARY ***
Total pot 1260 | No rake
Board: [Kd 2d 5c 2c 4d]
Seat 6: sabre_laser (small blind) showed [Tc 5h] and lost with Two pairs : 5 and 2
Seat 8: Franz1317 (big blind) showed [Th Kh] and won 1260 with Two pairs : Kings and 2


Winamax Poker - Tournament "No Limit Hold'em" buyIn: 0,45€ + 0,05€ level: 3 - HandId: #445588443049754625-18-1418854542 - Holdem no limit (30/60) - 2014/12/17 22:15:42 UTC
Table: 'No Limit Hold'em(103746644)#0' 10-max (real money) Seat #6 is the button
Seat 1: rosti900 (2650)
Seat 2: molo_molo (1285)
Seat 3: saeba_xyz (1793)
Seat 4: x-lolilol (1745)
Seat 5: doopy00 (1345)
Seat 6: sabre_laser (3200)
Seat 8: Franz1317 (2185)
Seat 9: thiga69 (797)
*** ANTE/BLINDS ***
Franz1317 posts small blind 30
thiga69 posts big blind 60
Dealt to sabre_laser [Kc 4h]
*** PRE-FLOP *** 
rosti900 folds
molo_molo folds
saeba_xyz raises 120 to 180
x-lolilol folds
doopy00 folds
sabre_laser folds
Franz1317 folds
thiga69 folds
saeba_xyz collected 270 from pot
*** SUMMARY ***
Total pot 270 | No rake
Seat 3: saeba_xyz won 270


Winamax Poker - Tournament "No Limit Hold'em" buyIn: 0,45€ + 0,05€ level: 3 - HandId: #445588443049754625-19-1418854572 - Holdem no limit (30/60) - 2014/12/17 22:16:12 UTC
Table: 'No Limit Hold'em(103746644)#0' 10-max (real money) Seat #8 is the button
Seat 1: rosti900 (2650)
Seat 2: molo_molo (1285)
Seat 3: saeba_xyz (1883)
Seat 4: x-lolilol (1745)
Seat 5: doopy00 (1345)
Seat 6: sabre_laser (3200)
Seat 8: Franz1317 (2155)
Seat 9: thiga69 (737)
*** ANTE/BLINDS ***
thiga69 posts small blind 30
rosti900 posts big blind 60
Dealt to sabre_laser [3s Jd]
*** PRE-FLOP *** 
molo_molo folds
saeba_xyz calls 60
x-lolilol folds
doopy00 calls 60
sabre_laser folds
Franz1317 folds
thiga69 calls 30
rosti900 checks
*** FLOP *** [Qc 2c Jc]
thiga69 checks
rosti900 checks
saeba_xyz bets 120
doopy00 folds
thiga69 calls 120
rosti900 folds
*** TURN *** [Qc 2c Jc][3c]
thiga69 checks
saeba_xyz checks
*** RIVER *** [Qc 2c Jc 3c][6d]
thiga69 bets 480
saeba_xyz folds
thiga69 collected 960 from pot
*** SUMMARY ***
Total pot 960 | No rake
Board: [Qc 2c Jc 3c 6d]
Seat 9: thiga69 (small blind) won 960


Winamax Poker - Tournament "No Limit Hold'em" buyIn: 0,45€ + 0,05€ level: 3 - HandId: #445588443049754625-20-1418854670 - Holdem no limit (30/60) - 2014/12/17 22:17:50 UTC
Table: 'No Limit Hold'em(103746644)#0' 10-max (real money) Seat #9 is the button
Seat 1: rosti900 (2590)
Seat 2: molo_molo (1285)
Seat 3: saeba_xyz (1703)
Seat 4: x-lolilol (1745)
Seat 5: doopy00 (1285)
Seat 6: sabre_laser (3200)
Seat 8: Franz1317 (2155)
Seat 9: thiga69 (1037)
*** ANTE/BLINDS ***
rosti900 posts small blind 30
molo_molo posts big blind 60
Dealt to sabre_laser [9h Th]
*** PRE-FLOP *** 
saeba_xyz folds
x-lolilol folds
doopy00 folds
sabre_laser raises 60 to 120
Franz1317 folds
thiga69 folds
rosti900 calls 90
molo_molo folds
*** FLOP *** [8c 7c 7h]
rosti900 checks
sabre_laser checks
*** TURN *** [8c 7c 7h][Ac]
rosti900 checks
sabre_laser bets 150
rosti900 folds
sabre_laser collected 450 from pot
*** SUMMARY ***
Total pot 450 | No rake
Board: [8c 7c 7h Ac]
Seat 6: sabre_laser won 450


Winamax Poker - Tournament "No Limit Hold'em" buyIn: 0,45€ + 0,05€ level: 3 - HandId: #445588443049754625-21-1418854748 - Holdem no limit (30/60) - 2014/12/17 22:19:08 UTC
Table: 'No Limit Hold'em(103746644)#0' 10-max (real money) Seat #1 is the button
Seat 1: rosti900 (2470)
Seat 2: molo_molo (1225)
Seat 3: saeba_xyz (1703)
Seat 4: x-lolilol (1745)
Seat 5: doopy00 (1285)
Seat 6: sabre_laser (3380)
Seat 8: Franz1317 (2155)
Seat 9: thiga69 (1037)
*** ANTE/BLINDS ***
molo_molo posts small blind 30
saeba_xyz posts big blind 60
Dealt to sabre_laser [Ad Jd]
*** PRE-FLOP *** 
x-lolilol folds
doopy00 folds
sabre_laser raises 60 to 120
Franz1317 folds
thiga69 folds
rosti900 raises 360 to 480
molo_molo folds
saeba_xyz folds
sabre_laser calls 360
*** FLOP *** [4c Qd 7h]
sabre_laser checks
rosti900 bets 360
sabre_laser folds
rosti900 collected 1410 from pot
*** SUMMARY ***
Total pot 1410 | No rake
Board: [4c Qd 7h]
Seat 1: rosti900 (button) won 1410


Winamax Poker - Tournament "No Limit Hold'em" buyIn: 0,45€ + 0,05€ level: 4 - HandId: #445588443049754625-22-1418854835 - Holdem no limit (40/80) - 2014/12/17 22:20:35 UTC
Table: 'No Limit Hold'em(103746644)#0' 10-max (real money) Seat #2 is the button
Seat 1: rosti900 (3040)
Seat 2: molo_molo (1195)
Seat 3: saeba_xyz (1643)
Seat 4: x-lolilol (1745)
Seat 5: doopy00 (1285)
Seat 6: sabre_laser (2900)
Seat 8: Franz1317 (2155)
Seat 9: thiga69 (1037)
*** ANTE/BLINDS ***
saeba_xyz posts small blind 40
x-lolilol posts big blind 80
Dealt to sabre_laser [5s Kc]
*** PRE-FLOP *** 
doopy00 folds
sabre_laser folds
Franz1317 folds
thiga69 calls 80
rosti900 folds
molo_molo folds
saeba_xyz calls 40
x-lolilol checks
*** FLOP *** [9h 4s Qs]
saeba_xyz bets 120
x-lolilol folds
thiga69 calls 120
*** TURN *** [9h 4s Qs][3c]
saeba_xyz bets 240
thiga69 folds
saeba_xyz collected 720 from pot
*** SUMMARY ***
Total pot 720 | No rake
Board: [9h 4s Qs 3c]
Seat 3: saeba_xyz (small blind) won 720


Winamax Poker - Tournament "No Limit Hold'em" buyIn: 0,45€ + 0,05€ level: 4 - HandId: #445588443049754625-23-1418854941 - Holdem no limit (40/80) - 2014/12/17 22:22:21 UTC
Table: 'No Limit Hold'em(103746644)#0' 10-max (real money) Seat #3 is the button
Seat 1: rosti900 (3040)
Seat 2: molo_molo (1195)
Seat 3: saeba_xyz (1923)
Seat 4: x-lolilol (1665)
Seat 5: doopy00 (1285)
Seat 6: sabre_laser (2900)
Seat 8: Franz1317 (2155)
Seat 9: thiga69 (837)
*** ANTE/BLINDS ***
x-lolilol posts small blind 40
doopy00 posts big blind 80
Dealt to sabre_laser [Jh Th]
*** PRE-FLOP *** 
sabre_laser calls 80
Franz1317 folds
thiga69 folds
rosti900 calls 80
molo_molo folds
saeba_xyz calls 80
x-lolilol folds
doopy00 checks
*** FLOP *** [4c Td Js]
doopy00 checks
sabre_laser bets 120
rosti900 raises 240 to 360
saeba_xyz folds
doopy00 folds
sabre_laser raises 1080 to 1440
rosti900 calls 1080
*** TURN *** [4c Td Js][2s]
sabre_laser bets 1380 and is all-in
rosti900 calls 1380
*** RIVER *** [4c Td Js 2s][3s]
*** SHOW DOWN ***
rosti900 shows [Jc Tc] (Two pairs : Jacks and Tens)
sabre_laser shows [Jh Th] (Two pairs : Jacks and Tens)
sabre_laser collected 3000 from pot
rosti900 collected 3000 from pot
*** SUMMARY ***
Total pot 6000 | No rake
Board: [4c Td Js 2s 3s]
Seat 1: rosti900 showed [Jc Tc] and won 3000 with Two pairs : Jacks and Tens
Seat 6: sabre_laser showed [Jh Th] and won 3000 with Two pairs : Jacks and Tens


Winamax Poker - Tournament "No Limit Hold'em" buyIn: 0,45€ + 0,05€ level: 4 - HandId: #445588443049754625-24-1418855062 - Holdem no limit (40/80) - 2014/12/17 22:24:22 UTC
Table: 'No Limit Hold'em(103746644)#0' 10-max (real money) Seat #4 is the button
Seat 1: rosti900 (3140)
Seat 2: molo_molo (1195)
Seat 3: saeba_xyz (1843)
Seat 4: x-lolilol (1625)
Seat 5: doopy00 (1205)
Seat 6: sabre_laser (3000)
Seat 8: Franz1317 (2155)
Seat 9: thiga69 (837)
*** ANTE/BLINDS ***
doopy00 posts small blind 40
sabre_laser posts big blind 80
Dealt to sabre_laser [3s 6d]
*** PRE-FLOP *** 
Franz1317 folds
thiga69 calls 80
rosti900 folds
molo_molo raises 80 to 160
saeba_xyz folds
x-lolilol folds
doopy00 folds
sabre_laser calls 80
thiga69 calls 80
*** FLOP *** [Qs 8h 8s]
sabre_laser checks
thiga69 bets 80
molo_molo calls 80
sabre_laser folds
*** TURN *** [Qs 8h 8s][9h]
thiga69 bets 340
molo_molo folds
thiga69 collected 1020 from pot
*** SUMMARY ***
Total pot 1020 | No rake
Board: [Qs 8h 8s 9h]
Seat 9: thiga69 won 1020


Winamax Poker - Tournament "No Limit Hold'em" buyIn: 0,45€ + 0,05€ level: 4 - HandId: #445588443049754625-25-1418855190 - Holdem no limit (40/80) - 2014/12/17 22:26:30 UTC
Table: 'No Limit Hold'em(103746644)#0' 10-max (real money) Seat #5 is the button
Seat 1: rosti900 (3140)
Seat 2: molo_molo (955)
Seat 3: saeba_xyz (1843)
Seat 4: x-lolilol (1625)
Seat 5: doopy00 (1165)
Seat 6: sabre_laser (2840)
Seat 8: Franz1317 (2155)
Seat 9: thiga69 (1277)
*** ANTE/BLINDS ***
sabre_laser posts small blind 40
Franz1317 posts big blind 80
Dealt to sabre_laser [Jc Th]
*** PRE-FLOP *** 
thiga69 folds
rosti900 folds
molo_molo folds
saeba_xyz folds
x-lolilol folds
doopy00 folds
sabre_laser calls 40
Franz1317 checks
*** FLOP *** [4c 6h 3d]
sabre_laser checks
Franz1317 checks
*** TURN *** [4c 6h 3d][Tc]
sabre_laser bets 160
Franz1317 folds
sabre_laser collected 320 from pot
*** SUMMARY ***
Total pot 320 | No rake
Board: [4c 6h 3d Tc]
Seat 6: sabre_laser (small blind) won 320


Winamax Poker - Tournament "No Limit Hold'em" buyIn: 0,45€ + 0,05€ level: 4 - HandId: #445588443049754625-26-1418855250 - Holdem no limit (40/80) - 2014/12/17 22:27:30 UTC
Table: 'No Limit Hold'em(103746644)#0' 10-max (real money) Seat #6 is the button
Seat 1: rosti900 (3140)
Seat 2: molo_molo (955)
Seat 3: saeba_xyz (1843)
Seat 4: x-lolilol (1625)
Seat 5: doopy00 (1165)
Seat 6: sabre_laser (2920)
Seat 8: Franz1317 (2075)
Seat 9: thiga69 (1277)
*** ANTE/BLINDS ***
Franz1317 posts small blind 40
thiga69 posts big blind 80
Dealt to sabre_laser [Ks 7s]
*** PRE-FLOP *** 
rosti900 folds
molo_molo folds
saeba_xyz folds
x-lolilol folds
doopy00 raises 80 to 160
sabre_laser folds
Franz1317 folds
thiga69 folds
doopy00 collected 280 from pot
*** SUMMARY ***
Total pot 280 | No rake
Seat 5: doopy00 won 280


Winamax Poker - Tournament "No Limit Hold'em" buyIn: 0,45€ + 0,05€ level: 5 - HandId: #445588443049754625-27-1418855300 - Holdem no limit (60/120) - 2014/12/17 22:28:20 UTC
Table: 'No Limit Hold'em(103746644)#0' 10-max (real money) Seat #8 is the button
Seat 1: rosti900 (3140)
Seat 2: molo_molo (955)
Seat 3: saeba_xyz (1843)
Seat 4: x-lolilol (1625)
Seat 5: doopy00 (1285)
Seat 6: sabre_laser (2920)
Seat 8: Franz1317 (2035)
Seat 9: thiga69 (1197)
*** ANTE/BLINDS ***
thiga69 posts small blind 60
rosti900 posts big blind 120
Dealt to sabre_laser [7d 8d]
*** PRE-FLOP *** 
molo_molo folds
saeba_xyz folds
x-lolilol folds
doopy00 folds
sabre_laser calls 120
Franz1317 folds
thiga69 folds
rosti900 checks
*** FLOP *** [Ad Th Tc]
rosti900 checks
sabre_laser bets 300
rosti900 folds
sabre_laser collected 600 from pot
*** SUMMARY ***
Total pot 600 | No rake
Board: [Ad Th Tc]
Seat 6: sabre_laser won 600


Winamax Poker - Tournament "No Limit Hold'em" buyIn: 0,45€ + 0,05€ level: 5 - HandId: #445588443049754625-28-1418855355 - Holdem no limit (60/120) - 2014/12/17 22:29:15 UTC
Table: 'No Limit Hold'em(103746644)#0' 10-max (real money) Seat #9 is the button
Seat 1: rosti900 (3020)
Seat 2: molo_molo (955)
Seat 3: saeba_xyz (1843)
Seat 4: x-lolilol (1625)
Seat 5: doopy00 (1285)
Seat 6: sabre_laser (3100)
Seat 8: Franz1317 (2035)
Seat 9: thiga69 (1137)
*** ANTE/BLINDS ***
rosti900 posts small blind 60
molo_molo posts big blind 120
Dealt to sabre_laser [3s 4c]
*** PRE-FLOP *** 
saeba_xyz folds
x-lolilol folds
doopy00 folds
sabre_laser folds
Franz1317 folds
thiga69 calls 120
rosti900 folds
molo_molo checks
*** FLOP *** [6c 3c Qc]
molo_molo checks
thiga69 checks
*** TURN *** [6c 3c Qc][Ts]
molo_molo checks
thiga69 bets 120
molo_molo folds
thiga69 collected 420 from pot
*** SUMMARY ***
Total pot 420 | No rake
Board: [6c 3c Qc Ts]
Seat 9: thiga69 (button) won 420


Winamax Poker - Tournament "No Limit Hold'em" buyIn: 0,45€ + 0,05€ level: 5 - HandId: #445588443049754625-29-1418855415 - Holdem no limit (60/120) - 2014/12/17 22:30:15 UTC
Table: 'No Limit Hold'em(103746644)#0' 10-max (real money) Seat #1 is the button
Seat 1: rosti900 (2960)
Seat 2: molo_molo (835)
Seat 3: saeba_xyz (1843)
Seat 4: x-lolilol (1625)
Seat 5: doopy00 (1285)
Seat 6: sabre_laser (3100)
Seat 8: Franz1317 (2035)
Seat 9: thiga69 (1317)
*** ANTE/BLINDS ***
molo_molo posts small blind 60
saeba_xyz posts big blind 120
Dealt to sabre_laser [Qd 2d]
*** PRE-FLOP *** 
x-lolilol folds
doopy00 folds
sabre_laser folds
Franz1317 folds
thiga69 folds
rosti900 folds
molo_molo folds
saeba_xyz collected 180 from pot
*** SUMMARY ***
Total pot 180 | No rake
Seat 3: saeba_xyz (big blind) won 180


Winamax Poker - Tournament "No Limit Hold'em" buyIn: 0,45€ + 0,05€ level: 5 - HandId: #445588443049754625-30-1418855435 - Holdem no limit (60/120) - 2014/12/17 22:30:35 UTC
Table: 'No Limit Hold'em(103746644)#0' 10-max (real money) Seat #2 is the button
Seat 1: rosti900 (2960)
Seat 2: molo_molo (775)
Seat 3: saeba_xyz (1903)
Seat 4: x-lolilol (1625)
Seat 5: doopy00 (1285)
Seat 6: sabre_laser (3100)
Seat 8: Franz1317 (2035)
Seat 9: thiga69 (1317)
*** ANTE/BLINDS ***
saeba_xyz posts small blind 60
x-lolilol posts big blind 120
Dealt to sabre_laser [9c 8s]
*** PRE-FLOP *** 
doopy00 raises 120 to 240
sabre_laser folds
Franz1317 folds
thiga69 folds
rosti900 folds
molo_molo raises 535 to 775 and is all-in
saeba_xyz folds
x-lolilol folds
doopy00 calls 535
*** FLOP *** [6s Ks 2h]
*** TURN *** [6s Ks 2h][3d]
*** RIVER *** [6s Ks 2h 3d][9d]
*** SHOW DOWN ***
molo_molo shows [Ac 5c] (High card : Ace)
doopy00 shows [Jd Ah] (High card : Ace)
doopy00 collected 1730 from pot
*** SUMMARY ***
Total pot 1730 | No rake
Board: [6s Ks 2h 3d 9d]
Seat 2: molo_molo (button) showed [Ac 5c] and lost with High card : Ace
Seat 5: doopy00 showed [Jd Ah] and won 1730 with High card : Ace


Winamax Poker - Tournament "No Limit Hold'em" buyIn: 0,45€ + 0,05€ level: 5 - HandId: #445588443049754625-31-1418855492 - Holdem no limit (60/120) - 2014/12/17 22:31:32 UTC
Table: 'No Limit Hold'em(103746644)#0' 10-max (real money) Seat #3 is the button
Seat 1: rosti900 (2960)
Seat 3: saeba_xyz (1843)
Seat 4: x-lolilol (1505)
Seat 5: doopy00 (2240)
Seat 6: sabre_laser (3100)
Seat 8: Franz1317 (2035)
Seat 9: thiga69 (1317)
*** ANTE/BLINDS ***
x-lolilol posts small blind 60
doopy00 posts big blind 120
Dealt to sabre_laser [4s 4c]
*** PRE-FLOP *** 
sabre_laser calls 120
Franz1317 folds
thiga69 folds
rosti900 folds
saeba_xyz calls 120
x-lolilol folds
doopy00 checks
*** FLOP *** [Th 2d 8c]
doopy00 bets 420
sabre_laser folds
saeba_xyz folds
doopy00 collected 840 from pot
*** SUMMARY ***
Total pot 840 | No rake
Board: [Th 2d 8c]
Seat 5: doopy00 (big blind) won 840


Winamax Poker - Tournament "No Limit Hold'em" buyIn: 0,45€ + 0,05€ level: 5 - HandId: #445588443049754625-32-1418855555 - Holdem no limit (60/120) - 2014/12/17 22:32:35 UTC
Table: 'No Limit Hold'em(103746644)#0' 10-max (real money) Seat #4 is the button
Seat 1: rosti900 (2960)
Seat 3: saeba_xyz (1723)
Seat 4: x-lolilol (1445)
Seat 5: doopy00 (2540)
Seat 6: sabre_laser (2980)
Seat 8: Franz1317 (2035)
Seat 9: thiga69 (1317)
*** ANTE/BLINDS ***
doopy00 posts small blind 60
sabre_laser posts big blind 120
Dealt to sabre_laser [Jh Qs]
*** PRE-FLOP *** 
Franz1317 folds
thiga69 folds
rosti900 folds
saeba_xyz folds
x-lolilol folds
doopy00 folds
sabre_laser collected 180 from pot
*** SUMMARY ***
Total pot 180 | No rake
Seat 6: sabre_laser (big blind) won 180


Winamax Poker - Tournament "No Limit Hold'em" buyIn: 0,45€ + 0,05€ level: 5 - HandId: #445588443049754625-33-1418855609 - Holdem no limit (60/120) - 2014/12/17 22:33:29 UTC
Table: 'No Limit Hold'em(103746644)#0' 10-max (real money) Seat #5 is the button
Seat 1: rosti900 (2960)
Seat 3: saeba_xyz (1723)
Seat 4: x-lolilol (1445)
Seat 5: doopy00 (2480)
Seat 6: sabre_laser (3040)
Seat 8: Franz1317 (2035)
Seat 9: thiga69 (1317)
*** ANTE/BLINDS ***
sabre_laser posts small blind 60
Franz1317 posts big blind 120
Dealt to sabre_laser [Jd Jc]
*** PRE-FLOP *** 
thiga69 folds
rosti900 folds
saeba_xyz folds
x-lolilol raises 240 to 360
doopy00 folds
sabre_laser raises 2680 to 3040 and is all-in
Franz1317 folds
x-lolilol folds
sabre_laser collected 3520 from pot
*** SUMMARY ***
Total pot 3520 | No rake
Seat 6: sabre_laser (small blind) won 3520


Winamax Poker - Tournament "No Limit Hold'em" buyIn: 0,45€ + 0,05€ level: 5 - HandId: #445588443049754625-34-1418855673 - Holdem no limit (60/120) - 2014/12/17 22:34:33 UTC
Table: 'No Limit Hold'em(103746644)#0' 10-max (real money) Seat #6 is the button
Seat 1: rosti900 (2960)
Seat 3: saeba_xyz (1723)
Seat 4: x-lolilol (1085)
Seat 5: doopy00 (2480)
Seat 6: sabre_laser (3520)
Seat 8: Franz1317 (1915)
Seat 9: thiga69 (1317)
*** ANTE/BLINDS ***
Franz1317 posts small blind 60
thiga69 posts big blind 120
Dealt to sabre_laser [8h 2d]
*** PRE-FLOP *** 
rosti900 folds
saeba_xyz folds
x-lolilol folds
doopy00 folds
sabre_laser folds
Franz1317 folds
thiga69 collected 180 from pot
*** SUMMARY ***
Total pot 180 | No rake
Seat 9: thiga69 (big blind) won 180


Winamax Poker - Tournament "No Limit Hold'em" buyIn: 0,45€ + 0,05€ level: 5 - HandId: #445588443049754625-35-1418855687 - Holdem no limit (60/120) - 2014/12/17 22:34:47 UTC
Table: 'No Limit Hold'em(103746644)#0' 10-max (real money) Seat #8 is the button
Seat 1: rosti900 (2960)
Seat 3: saeba_xyz (1723)
Seat 4: x-lolilol (1085)
Seat 5: doopy00 (2480)
Seat 6: sabre_laser (3520)
Seat 8: Franz1317 (1855)
Seat 9: thiga69 (1377)
*** ANTE/BLINDS ***
thiga69 posts small blind 60
rosti900 posts big blind 120
Dealt to sabre_laser [4d 4h]
*** PRE-FLOP *** 
saeba_xyz folds
x-lolilol folds
doopy00 folds
sabre_laser calls 120
Franz1317 raises 1735 to 1855 and is all-in
thiga69 folds
rosti900 folds
sabre_laser folds
Franz1317 collected 2155 from pot
*** SUMMARY ***
Total pot 2155 | No rake
Seat 8: Franz1317 (button) won 2155


Winamax Poker - Tournament "No Limit Hold'em" buyIn: 0,45€ + 0,05€ level: 5 - HandId: #445588443049754625-36-1418855716 - Holdem no limit (60/120) - 2014/12/17 22:35:16 UTC
Table: 'No Limit Hold'em(103746644)#0' 10-max (real money) Seat #9 is the button
Seat 1: rosti900 (2840)
Seat 3: saeba_xyz (1723)
Seat 4: x-lolilol (1085)
Seat 5: doopy00 (2480)
Seat 6: sabre_laser (3400)
Seat 8: Franz1317 (2155)
Seat 9: thiga69 (1317)
*** ANTE/BLINDS ***
rosti900 posts small blind 60
saeba_xyz posts big blind 120
Dealt to sabre_laser [8s Ks]
*** PRE-FLOP *** 
x-lolilol folds
doopy00 folds
sabre_laser calls 120
Franz1317 folds
thiga69 raises 120 to 240
rosti900 folds
saeba_xyz folds
sabre_laser calls 120
*** FLOP *** [Qc 3c 7c]
sabre_laser checks
thiga69 bets 120
sabre_laser folds
thiga69 collected 780 from pot
*** SUMMARY ***
Total pot 780 | No rake
Board: [Qc 3c 7c]
Seat 9: thiga69 (button) won 780


Winamax Poker - Tournament "No Limit Hold'em" buyIn: 0,45€ + 0,05€ level: 6 - HandId: #445588443049754625-37-1418855771 - Holdem no limit (80/160) - 2014/12/17 22:36:11 UTC
Table: 'No Limit Hold'em(103746644)#0' 10-max (real money) Seat #1 is the button
Seat 1: rosti900 (2780)
Seat 3: saeba_xyz (1603)
Seat 4: x-lolilol (1085)
Seat 5: doopy00 (2480)
Seat 6: sabre_laser (3160)
Seat 8: Franz1317 (2155)
Seat 9: thiga69 (1737)
*** ANTE/BLINDS ***
saeba_xyz posts small blind 80
x-lolilol posts big blind 160
Dealt to sabre_laser [Ac Td]
*** PRE-FLOP *** 
doopy00 folds
sabre_laser calls 160
Franz1317 folds
thiga69 folds
rosti900 folds
saeba_xyz folds
x-lolilol checks
*** FLOP *** [8s 2d 3c]
x-lolilol checks
sabre_laser bets 3000 and is all-in
x-lolilol folds
sabre_laser collected 3400 from pot
*** SUMMARY ***
Total pot 3400 | No rake
Board: [8s 2d 3c]
Seat 6: sabre_laser won 3400


Winamax Poker - Tournament "No Limit Hold'em" buyIn: 0,45€ + 0,05€ level: 6 - HandId: #445588443049754625-38-1418855884 - Holdem no limit (80/160) - 2014/12/17 22:38:04 UTC
Table: 'No Limit Hold'em(103746644)#0' 10-max (real money) Seat #3 is the button
Seat 1: rosti900 (2780)
Seat 3: saeba_xyz (1523)
Seat 4: x-lolilol (925)
Seat 5: doopy00 (2480)
Seat 6: sabre_laser (3400)
Seat 8: Franz1317 (2155)
Seat 9: thiga69 (1737)
*** ANTE/BLINDS ***
x-lolilol posts small blind 80
doopy00 posts big blind 160
Dealt to sabre_laser [4c 2c]
*** PRE-FLOP *** 
sabre_laser folds
Franz1317 folds
thiga69 calls 160
rosti900 folds
saeba_xyz folds
x-lolilol folds
doopy00 checks
*** FLOP *** [Kd 8d Jd]
doopy00 checks
thiga69 checks
*** TURN *** [Kd 8d Jd][3h]
doopy00 checks
thiga69 bets 160
doopy00 folds
thiga69 collected 560 from pot
*** SUMMARY ***
Total pot 560 | No rake
Board: [Kd 8d Jd 3h]
Seat 9: thiga69 won 560


Winamax Poker - Tournament "No Limit Hold'em" buyIn: 0,45€ + 0,05€ level: 6 - HandId: #445588443049754625-39-1418855966 - Holdem no limit (80/160) - 2014/12/17 22:39:26 UTC
Table: 'No Limit Hold'em(103746644)#0' 10-max (real money) Seat #4 is the button
Seat 1: rosti900 (2780)
Seat 3: saeba_xyz (1523)
Seat 4: x-lolilol (845)
Seat 5: doopy00 (2320)
Seat 6: sabre_laser (3400)
Seat 8: Franz1317 (2155)
Seat 9: thiga69 (1977)
*** ANTE/BLINDS ***
doopy00 posts small blind 80
sabre_laser posts big blind 160
Dealt to sabre_laser [7h 5s]
*** PRE-FLOP *** 
Franz1317 folds
thiga69 calls 160
rosti900 calls 160
saeba_xyz folds
x-lolilol folds
doopy00 folds
sabre_laser checks
*** FLOP *** [Jc 3c Qd]
sabre_laser checks
thiga69 bets 160
rosti900 calls 160
sabre_laser folds
*** TURN *** [Jc 3c Qd][3d]
thiga69 bets 160
rosti900 calls 160
*** RIVER *** [Jc 3c Qd 3d][8d]
thiga69 bets 600
rosti900 folds
thiga69 collected 1800 from pot
*** SUMMARY ***
Total pot 1800 | No rake
Board: [Jc 3c Qd 3d 8d]
Seat 9: thiga69 won 1800


Winamax Poker - Tournament "No Limit Hold'em" buyIn: 0,45€ + 0,05€ level: 6 - HandId: #445588443049754625-40-1418856035 - Holdem no limit (80/160) - 2014/12/17 22:40:35 UTC
Table: 'No Limit Hold'em(103746644)#0' 10-max (real money) Seat #5 is the button
Seat 1: rosti900 (2300)
Seat 3: saeba_xyz (1523)
Seat 4: x-lolilol (845)
Seat 5: doopy00 (2240)
Seat 6: sabre_laser (3240)
Seat 8: Franz1317 (2155)
Seat 9: thiga69 (2697)
*** ANTE/BLINDS ***
sabre_laser posts small blind 80
Franz1317 posts big blind 160
Dealt to sabre_laser [3c Td]
*** PRE-FLOP *** 
thiga69 folds
rosti900 folds
saeba_xyz folds
x-lolilol folds
doopy00 folds
sabre_laser raises 160 to 320
Franz1317 folds
sabre_laser collected 480 from pot
*** SUMMARY ***
Total pot 480 | No rake
Seat 6: sabre_laser (small blind) won 480


Winamax Poker - Tournament "No Limit Hold'em" buyIn: 0,45€ + 0,05€ level: 6 - HandId: #445588443049754625-41-1418856077 - Holdem no limit (80/160) - 2014/12/17 22:41:17 UTC
Table: 'No Limit Hold'em(103746644)#0' 10-max (real money) Seat #6 is the button
Seat 1: rosti900 (2300)
Seat 3: saeba_xyz (1523)
Seat 4: x-lolilol (845)
Seat 5: doopy00 (2240)
Seat 6: sabre_laser (3400)
Seat 8: Franz1317 (1995)
Seat 9: thiga69 (2697)
*** ANTE/BLINDS ***
Franz1317 posts small blind 80
thiga69 posts big blind 160
Dealt to sabre_laser [5s 4c]
*** PRE-FLOP *** 
rosti900 folds
saeba_xyz folds
x-lolilol raises 685 to 845 and is all-in
doopy00 folds
sabre_laser folds
Franz1317 folds
thiga69 folds
x-lolilol collected 1085 from pot
*** SUMMARY ***
Total pot 1085 | No rake
Seat 4: x-lolilol won 1085


Winamax Poker - Tournament "No Limit Hold'em" buyIn: 0,45€ + 0,05€ level: 6 - HandId: #445588443049754625-42-1418856117 - Holdem no limit (80/160) - 2014/12/17 22:41:57 UTC
Table: 'No Limit Hold'em(103746644)#0' 10-max (real money) Seat #8 is the button
Seat 1: rosti900 (2300)
Seat 3: saeba_xyz (1523)
Seat 4: x-lolilol (1085)
Seat 5: doopy00 (2240)
Seat 6: sabre_laser (3400)
Seat 8: Franz1317 (1915)
Seat 9: thiga69 (2537)
*** ANTE/BLINDS ***
thiga69 posts small blind 80
rosti900 posts big blind 160
Dealt to sabre_laser [Qs 4s]
*** PRE-FLOP *** 
saeba_xyz folds
x-lolilol folds
doopy00 calls 160
sabre_laser folds
Franz1317 folds
thiga69 calls 80
rosti900 checks
*** FLOP *** [4d 8h 8s]
thiga69 bets 160
rosti900 folds
doopy00 folds
thiga69 collected 640 from pot
*** SUMMARY ***
Total pot 640 | No rake
Board: [4d 8h 8s]
Seat 9: thiga69 (small blind) won 640


Winamax Poker - Tournament "No Limit Hold'em" buyIn: 0,45€ + 0,05€ level: 6 - HandId: #445588443049754625-43-1418856163 - Holdem no limit (80/160) - 2014/12/17 22:42:43 UTC
Table: 'No Limit Hold'em(103746644)#0' 10-max (real money) Seat #9 is the button
Seat 1: rosti900 (2140)
Seat 3: saeba_xyz (1523)
Seat 4: x-lolilol (1085)
Seat 5: doopy00 (2080)
Seat 6: sabre_laser (3400)
Seat 8: Franz1317 (1915)
Seat 9: thiga69 (2857)
*** ANTE/BLINDS ***
rosti900 posts small blind 80
saeba_xyz posts big blind 160
Dealt to sabre_laser [6d 3c]
*** PRE-FLOP *** 
x-lolilol folds
doopy00 folds
sabre_laser folds
Franz1317 folds
thiga69 folds
rosti900 raises 160 to 320
saeba_xyz folds
rosti900 collected 480 from pot
*** SUMMARY ***
Total pot 480 | No rake
Seat 1: rosti900 (small blind) won 480


Winamax Poker - Tournament "No Limit Hold'em" buyIn: 0,45€ + 0,05€ level: 6 - HandId: #445588443049754625-44-1418856191 - Holdem no limit (80/160) - 2014/12/17 22:43:11 UTC
Table: 'No Limit Hold'em(103746644)#0' 10-max (real money) Seat #1 is the button
Seat 1: rosti900 (2300)
Seat 3: saeba_xyz (1363)
Seat 4: x-lolilol (1085)
Seat 5: doopy00 (2080)
Seat 6: sabre_laser (3400)
Seat 8: Franz1317 (1915)
Seat 9: thiga69 (2857)
*** ANTE/BLINDS ***
saeba_xyz posts small blind 80
x-lolilol posts big blind 160
Dealt to sabre_laser [Ac Kd]
*** PRE-FLOP *** 
doopy00 folds
sabre_laser raises 160 to 320
Franz1317 folds
thiga69 folds
rosti900 folds
saeba_xyz folds
x-lolilol raises 765 to 1085 and is all-in
sabre_laser calls 765
*** FLOP *** [4c Td Ad]
*** TURN *** [4c Td Ad][6h]
*** RIVER *** [4c Td Ad 6h][2c]
*** SHOW DOWN ***
x-lolilol shows [Ks Qs] (High card : Ace)
sabre_laser shows [Ac Kd] (One pair : Aces)
sabre_laser collected 2250 from pot
*** SUMMARY ***
Total pot 2250 | No rake
Board: [4c Td Ad 6h 2c]
Seat 4: x-lolilol (big blind) showed [Ks Qs] and lost with High card : Ace
Seat 6: sabre_laser showed [Ac Kd] and won 2250 with One pair : Aces


Winamax Poker - Tournament "No Limit Hold'em" buyIn: 0,45€ + 0,05€ level: 7 - HandId: #445588443049754625-45-1418856238 - Holdem no limit (10/100/200) - 2014/12/17 22:43:58 UTC
Table: 'No Limit Hold'em(103746644)#0' 10-max (real money) Seat #3 is the button
Seat 1: rosti900 (2300)
Seat 3: saeba_xyz (1283)
Seat 5: doopy00 (2080)
Seat 6: sabre_laser (4565)
Seat 8: Franz1317 (1915)
Seat 9: thiga69 (2857)
*** ANTE/BLINDS ***
doopy00 posts ante 10
rosti900 posts ante 10
saeba_xyz posts ante 10
sabre_laser posts ante 10
Franz1317 posts ante 10
thiga69 posts ante 10
doopy00 posts big blind 200
Dealt to sabre_laser [9s Jd]
*** PRE-FLOP *** 
sabre_laser folds
Franz1317 folds
thiga69 raises 200 to 400
rosti900 folds
saeba_xyz folds
doopy00 calls 200
*** FLOP *** [4c 2c Jh]
doopy00 checks
thiga69 bets 430
doopy00 folds
thiga69 collected 1290 from pot
*** SUMMARY ***
Total pot 1290 | No rake
Board: [4c 2c Jh]
Seat 9: thiga69 won 1290


Winamax Poker - Tournament "No Limit Hold'em" buyIn: 0,45€ + 0,05€ level: 7 - HandId: #445588443049754625-46-1418856265 - Holdem no limit (10/100/200) - 2014/12/17 22:44:25 UTC
Table: 'No Limit Hold'em(103746644)#0' 10-max (real money) Seat #4 is the button
Seat 1: rosti900 (2290)
Seat 3: saeba_xyz (1273)
Seat 5: doopy00 (1670)
Seat 6: sabre_laser (4555)
Seat 8: Franz1317 (1905)
Seat 9: thiga69 (3307)
*** ANTE/BLINDS ***
doopy00 posts ante 10
sabre_laser posts ante 10
rosti900 posts ante 10
saeba_xyz posts ante 10
Franz1317 posts ante 10
thiga69 posts ante 10
doopy00 posts small blind 100
sabre_laser posts big blind 200
Dealt to sabre_laser [Ks Jc]
*** PRE-FLOP *** 
Franz1317 folds
thiga69 folds
rosti900 raises 400 to 600
saeba_xyz folds
doopy00 folds
sabre_laser calls 400
*** FLOP *** [Ts 5c 2c]
sabre_laser checks
rosti900 bets 1680 and is all-in
sabre_laser folds
rosti900 collected 3040 from pot
*** SUMMARY ***
Total pot 3040 | No rake
Board: [Ts 5c 2c]
Seat 1: rosti900 won 3040


Winamax Poker - Tournament "No Limit Hold'em" buyIn: 0,45€ + 0,05€ level: 7 - HandId: #445588443049754625-47-1418856305 - Holdem no limit (10/100/200) - 2014/12/17 22:45:05 UTC
Table: 'No Limit Hold'em(103746644)#0' 10-max (real money) Seat #5 is the button
Seat 1: rosti900 (3040)
Seat 3: saeba_xyz (1263)
Seat 5: doopy00 (1560)
Seat 6: sabre_laser (3945)
Seat 8: Franz1317 (1895)
Seat 9: thiga69 (3297)
*** ANTE/BLINDS ***
sabre_laser posts ante 10
Franz1317 posts ante 10
rosti900 posts ante 10
saeba_xyz posts ante 10
doopy00 posts ante 10
thiga69 posts ante 10
sabre_laser posts small blind 100
Franz1317 posts big blind 200
Dealt to sabre_laser [2s Qc]
*** PRE-FLOP *** 
thiga69 folds
rosti900 folds
saeba_xyz folds
doopy00 raises 560 to 760
sabre_laser folds
Franz1317 folds
doopy00 collected 1120 from pot
*** SUMMARY ***
Total pot 1120 | No rake
Seat 5: doopy00 (button) won 1120


Winamax Poker - Tournament "No Limit Hold'em" buyIn: 0,45€ + 0,05€ level: 7 - HandId: #445588443049754625-48-1418856341 - Holdem no limit (10/100/200) - 2014/12/17 22:45:41 UTC
Table: 'No Limit Hold'em(103746644)#0' 10-max (real money) Seat #6 is the button
Seat 1: rosti900 (3030)
Seat 3: saeba_xyz (1253)
Seat 5: doopy00 (1910)
Seat 6: sabre_laser (3835)
Seat 8: Franz1317 (1685)
Seat 9: thiga69 (3287)
*** ANTE/BLINDS ***
Franz1317 posts ante 10
thiga69 posts ante 10
rosti900 posts ante 10
saeba_xyz posts ante 10
doopy00 posts ante 10
sabre_laser posts ante 10
Franz1317 posts small blind 100
thiga69 posts big blind 200
Dealt to sabre_laser [2s 3d]
*** PRE-FLOP *** 
rosti900 raises 400 to 600
saeba_xyz folds
doopy00 folds
sabre_laser folds
Franz1317 folds
thiga69 folds
rosti900 collected 960 from pot
*** SUMMARY ***
Total pot 960 | No rake
Seat 1: rosti900 won 960


Winamax Poker - Tournament "No Limit Hold'em" buyIn: 0,45€ + 0,05€ level: 7 - HandId: #445588443049754625-49-1418856357 - Holdem no limit (10/100/200) - 2014/12/17 22:45:57 UTC
Table: 'No Limit Hold'em(103746644)#0' 10-max (real money) Seat #8 is the button
Seat 1: rosti900 (3380)
Seat 3: saeba_xyz (1243)
Seat 5: doopy00 (1900)
Seat 6: sabre_laser (3825)
Seat 8: Franz1317 (1575)
Seat 9: thiga69 (3077)
*** ANTE/BLINDS ***
thiga69 posts ante 10
rosti900 posts ante 10
saeba_xyz posts ante 10
doopy00 posts ante 10
sabre_laser posts ante 10
Franz1317 posts ante 10
thiga69 posts small blind 100
rosti900 posts big blind 200
Dealt to sabre_laser [Kh 7s]
*** PRE-FLOP *** 
saeba_xyz raises 1033 to 1233 and is all-in
doopy00 folds
sabre_laser folds
Franz1317 folds
thiga69 folds
rosti900 folds
saeba_xyz collected 1593 from pot
*** SUMMARY ***
Total pot 1593 | No rake
Seat 3: saeba_xyz won 1593


Winamax Poker - Tournament "No Limit Hold'em" buyIn: 0,45€ + 0,05€ level: 7 - HandId: #445588443049754625-50-1418856388 - Holdem no limit (10/100/200) - 2014/12/17 22:46:28 UTC
Table: 'No Limit Hold'em(103746644)#0' 10-max (real money) Seat #9 is the button
Seat 1: rosti900 (3170)
Seat 3: saeba_xyz (1593)
Seat 5: doopy00 (1890)
Seat 6: sabre_laser (3815)
Seat 8: Franz1317 (1565)
Seat 9: thiga69 (2967)
*** ANTE/BLINDS ***
rosti900 posts ante 10
saeba_xyz posts ante 10
doopy00 posts ante 10
sabre_laser posts ante 10
Franz1317 posts ante 10
thiga69 posts ante 10
rosti900 posts small blind 100
saeba_xyz posts big blind 200
Dealt to sabre_laser [Ah 3c]
*** PRE-FLOP *** 
doopy00 raises 560 to 760
sabre_laser folds
Franz1317 folds
thiga69 folds
rosti900 folds
saeba_xyz folds
doopy00 collected 1120 from pot
*** SUMMARY ***
Total pot 1120 | No rake
Seat 5: doopy00 won 1120


Winamax Poker - Tournament "No Limit Hold'em" buyIn: 0,45€ + 0,05€ level: 7 - HandId: #445588443049754625-51-1418856414 - Holdem no limit (10/100/200) - 2014/12/17 22:46:54 UTC
Table: 'No Limit Hold'em(103746644)#0' 10-max (real money) Seat #1 is the button
Seat 1: rosti900 (3060)
Seat 3: saeba_xyz (1383)
Seat 5: doopy00 (2240)
Seat 6: sabre_laser (3805)
Seat 8: Franz1317 (1555)
Seat 9: thiga69 (2957)
*** ANTE/BLINDS ***
saeba_xyz posts ante 10
doopy00 posts ante 10
rosti900 posts ante 10
sabre_laser posts ante 10
Franz1317 posts ante 10
thiga69 posts ante 10
saeba_xyz posts small blind 100
doopy00 posts big blind 200
Dealt to sabre_laser [Kd 7s]
*** PRE-FLOP *** 
sabre_laser folds
Franz1317 raises 1345 to 1545 and is all-in
thiga69 folds
rosti900 folds
saeba_xyz folds
doopy00 folds
Franz1317 collected 1905 from pot
*** SUMMARY ***
Total pot 1905 | No rake
Seat 8: Franz1317 won 1905


Winamax Poker - Tournament "No Limit Hold'em" buyIn: 0,45€ + 0,05€ level: 7 - HandId: #445588443049754625-52-1418856440 - Holdem no limit (10/100/200) - 2014/12/17 22:47:20 UTC
Table: 'No Limit Hold'em(103746644)#0' 10-max (real money) Seat #3 is the button
Seat 1: rosti900 (3050)
Seat 3: saeba_xyz (1273)
Seat 5: doopy00 (2030)
Seat 6: sabre_laser (3795)
Seat 8: Franz1317 (1905)
Seat 9: thiga69 (2947)
*** ANTE/BLINDS ***
doopy00 posts ante 10
sabre_laser posts ante 10
rosti900 posts ante 10
saeba_xyz posts ante 10
Franz1317 posts ante 10
thiga69 posts ante 10
doopy00 posts small blind 100
sabre_laser posts big blind 200
Dealt to sabre_laser [6s 2s]
*** PRE-FLOP *** 
Franz1317 folds
thiga69 raises 200 to 400
rosti900 folds
saeba_xyz folds
doopy00 folds
sabre_laser folds
thiga69 collected 760 from pot
*** SUMMARY ***
Total pot 760 | No rake
Seat 9: thiga69 won 760


Winamax Poker - Tournament "No Limit Hold'em" buyIn: 0,45€ + 0,05€ level: 7 - HandId: #445588443049754625-53-1418856463 - Holdem no limit (10/100/200) - 2014/12/17 22:47:43 UTC
Table: 'No Limit Hold'em(103746644)#0' 10-max (real money) Seat #5 is the button
Seat 1: rosti900 (3040)
Seat 3: saeba_xyz (1263)
Seat 5: doopy00 (1920)
Seat 6: sabre_laser (3585)
Seat 8: Franz1317 (1895)
Seat 9: thiga69 (3297)
*** ANTE/BLINDS ***
sabre_laser posts ante 10
Franz1317 posts ante 10
rosti900 posts ante 10
saeba_xyz posts ante 10
doopy00 posts ante 10
thiga69 posts ante 10
sabre_laser posts small blind 100
Franz1317 posts big blind 200
Dealt to sabre_laser [8s Qd]
*** PRE-FLOP *** 
thiga69 folds
rosti900 calls 200
saeba_xyz folds
doopy00 folds
sabre_laser folds
Franz1317 checks
*** FLOP *** [Ks Tc 6h]
Franz1317 checks
rosti900 bets 400
Franz1317 folds
rosti900 collected 960 from pot
*** SUMMARY ***
Total pot 960 | No rake
Board: [Ks Tc 6h]
Seat 1: rosti900 won 960


Winamax Poker - Tournament "No Limit Hold'em" buyIn: 0,45€ + 0,05€ level: 7 - HandId: #445588443049754625-54-1418856500 - Holdem no limit (10/100/200) - 2014/12/17 22:48:20 UTC
Table: 'No Limit Hold'em(103746644)#0' 10-max (real money) Seat #6 is the button
Seat 1: rosti900 (3390)
Seat 3: saeba_xyz (1253)
Seat 5: doopy00 (1910)
Seat 6: sabre_laser (3475)
Seat 8: Franz1317 (1685)
Seat 9: thiga69 (3287)
*** ANTE/BLINDS ***
Franz1317 posts ante 10
thiga69 posts ante 10
rosti900 posts ante 10
saeba_xyz posts ante 10
doopy00 posts ante 10
sabre_laser posts ante 10
Franz1317 posts small blind 100
thiga69 posts big blind 200
Dealt to sabre_laser [Jc 4c]
*** PRE-FLOP *** 
rosti900 folds
saeba_xyz raises 1043 to 1243 and is all-in
doopy00 folds
sabre_laser folds
Franz1317 folds
thiga69 folds
saeba_xyz collected 1603 from pot
*** SUMMARY ***
Total pot 1603 | No rake
Seat 3: saeba_xyz won 1603


Winamax Poker - Tournament "No Limit Hold'em" buyIn: 0,45€ + 0,05€ level: 7 - HandId: #445588443049754625-55-1418856538 - Holdem no limit (10/100/200) - 2014/12/17 22:48:58 UTC
Table: 'No Limit Hold'em(103746644)#0' 10-max (real money) Seat #8 is the button
Seat 1: rosti900 (3380)
Seat 3: saeba_xyz (1603)
Seat 5: doopy00 (1900)
Seat 6: sabre_laser (3465)
Seat 8: Franz1317 (1575)
Seat 9: thiga69 (3077)
*** ANTE/BLINDS ***
thiga69 posts ante 10
rosti900 posts ante 10
saeba_xyz posts ante 10
doopy00 posts ante 10
sabre_laser posts ante 10
Franz1317 posts ante 10
thiga69 posts small blind 100
rosti900 posts big blind 200
Dealt to sabre_laser [8s 7s]
*** PRE-FLOP *** 
saeba_xyz raises 1393 to 1593 and is all-in
doopy00 folds
sabre_laser raises 1862 to 3455 and is all-in
Franz1317 folds
thiga69 folds
rosti900 folds
*** FLOP *** [3d 9s Th]
*** TURN *** [3d 9s Th][5d]
*** RIVER *** [3d 9s Th 5d][Ad]
*** SHOW DOWN ***
saeba_xyz shows [Kd Qc] (High card : Ace)
sabre_laser shows [8s 7s] (High card : Ace)
sabre_laser collected 1862 from side pot 1
saeba_xyz collected 3546 from main pot
*** SUMMARY ***
Total pot 5408 | No rake
Board: [3d 9s Th 5d Ad]
Seat 3: saeba_xyz showed [Kd Qc] and won 3546 with High card : Ace
Seat 6: sabre_laser showed [8s 7s] and won 1862 with High card : Ace


Winamax Poker - Tournament "No Limit Hold'em" buyIn: 0,45€ + 0,05€ level: 7 - HandId: #445588443049754625-56-1418856577 - Holdem no limit (10/100/200) - 2014/12/17 22:49:37 UTC
Table: 'No Limit Hold'em(103746644)#0' 10-max (real money) Seat #9 is the button
Seat 1: rosti900 (3170)
Seat 3: saeba_xyz (3546)
Seat 5: doopy00 (1890)
Seat 6: sabre_laser (1862)
Seat 8: Franz1317 (1565)
Seat 9: thiga69 (2967)
*** ANTE/BLINDS ***
rosti900 posts ante 10
saeba_xyz posts ante 10
doopy00 posts ante 10
sabre_laser posts ante 10
Franz1317 posts ante 10
thiga69 posts ante 10
rosti900 posts small blind 100
saeba_xyz posts big blind 200
Dealt to sabre_laser [3d 6s]
*** PRE-FLOP *** 
doopy00 folds
sabre_laser folds
Franz1317 folds
thiga69 raises 200 to 400
rosti900 folds
saeba_xyz calls 200
*** FLOP *** [Kd 2s 7c]
saeba_xyz checks
thiga69 bets 200
saeba_xyz calls 200
*** TURN *** [Kd 2s 7c][As]
saeba_xyz checks
thiga69 bets 200
saeba_xyz folds
thiga69 collected 1560 from pot
*** SUMMARY ***
Total pot 1560 | No rake
Board: [Kd 2s 7c As]
Seat 9: thiga69 (button) won 1560


Winamax Poker - Tournament "No Limit Hold'em" buyIn: 0,45€ + 0,05€ level: 7 - HandId: #445588443049754625-57-1418856639 - Holdem no limit (10/100/200) - 2014/12/17 22:50:39 UTC
Table: 'No Limit Hold'em(103746644)#0' 10-max (real money) Seat #1 is the button
Seat 1: rosti900 (3060)
Seat 3: saeba_xyz (2936)
Seat 5: doopy00 (1880)
Seat 6: sabre_laser (1852)
Seat 8: Franz1317 (1555)
Seat 9: thiga69 (3717)
*** ANTE/BLINDS ***
saeba_xyz posts ante 10
doopy00 posts ante 10
rosti900 posts ante 10
sabre_laser posts ante 10
Franz1317 posts ante 10
thiga69 posts ante 10
saeba_xyz posts small blind 100
doopy00 posts big blind 200
Dealt to sabre_laser [3c Qc]
*** PRE-FLOP *** 
sabre_laser folds
Franz1317 folds
thiga69 folds
rosti900 folds
saeba_xyz folds
doopy00 collected 360 from pot
*** SUMMARY ***
Total pot 360 | No rake
Seat 5: doopy00 (big blind) won 360


Winamax Poker - Tournament "No Limit Hold'em" buyIn: 0,45€ + 0,05€ level: 7 - HandId: #445588443049754625-58-1418856669 - Holdem no limit (10/100/200) - 2014/12/17 22:51:09 UTC
Table: 'No Limit Hold'em(103746644)#0' 10-max (real money) Seat #3 is the button
Seat 1: rosti900 (3050)
Seat 3: saeba_xyz (2826)
Seat 5: doopy00 (2030)
Seat 6: sabre_laser (1842)
Seat 8: Franz1317 (1545)
Seat 9: thiga69 (3707)
*** ANTE/BLINDS ***
doopy00 posts ante 10
sabre_laser posts ante 10
rosti900 posts ante 10
saeba_xyz posts ante 10
Franz1317 posts ante 10
thiga69 posts ante 10
doopy00 posts small blind 100
sabre_laser posts big blind 200
Dealt to sabre_laser [Qd Th]
*** PRE-FLOP *** 
Franz1317 folds
thiga69 raises 200 to 400
rosti900 folds
saeba_xyz raises 2416 to 2816 and is all-in
doopy00 folds
sabre_laser folds
thiga69 calls 2416
*** FLOP *** [8c Td 9d]
*** TURN *** [8c Td 9d][4d]
*** RIVER *** [8c Td 9d 4d][Jh]
*** SHOW DOWN ***
saeba_xyz shows [Ks Ad] (High card : Ace)
thiga69 shows [7h 7c] (Straight Jack high)
thiga69 collected 5992 from pot
*** SUMMARY ***
Total pot 5992 | No rake
Board: [8c Td 9d 4d Jh]
Seat 3: saeba_xyz (button) showed [Ks Ad] and lost with High card : Ace
Seat 9: thiga69 showed [7h 7c] and won 5992 with Straight Jack high


Winamax Poker - Tournament "No Limit Hold'em" buyIn: 0,45€ + 0,05€ level: 8 - HandId: #445588443049754625-59-1418856703 - Holdem no limit (20/150/300) - 2014/12/17 22:51:43 UTC
Table: 'No Limit Hold'em(103746644)#0' 10-max (real money) Seat #5 is the button
Seat 1: rosti900 (3040)
Seat 5: doopy00 (1920)
Seat 6: sabre_laser (1632)
Seat 8: Franz1317 (1535)
Seat 9: thiga69 (6873)
*** ANTE/BLINDS ***
sabre_laser posts ante 20
Franz1317 posts ante 20
rosti900 posts ante 20
doopy00 posts ante 20
thiga69 posts ante 20
sabre_laser posts small blind 150
Franz1317 posts big blind 300
Dealt to sabre_laser [Qc 2c]
*** PRE-FLOP *** 
thiga69 folds
rosti900 calls 300
doopy00 folds
sabre_laser calls 150
Franz1317 checks
*** FLOP *** [Kd 5c 2d]
sabre_laser checks
Franz1317 checks
rosti900 bets 300
sabre_laser folds
Franz1317 folds
rosti900 collected 1300 from pot
*** SUMMARY ***
Total pot 1300 | No rake
Board: [Kd 5c 2d]
Seat 1: rosti900 won 1300


Winamax Poker - Tournament "No Limit Hold'em" buyIn: 0,45€ + 0,05€ level: 8 - HandId: #445588443049754625-60-1418856752 - Holdem no limit (20/150/300) - 2014/12/17 22:52:32 UTC
Table: 'No Limit Hold'em(103746644)#0' 10-max (real money) Seat #6 is the button
Seat 1: rosti900 (3720)
Seat 5: doopy00 (1900)
Seat 6: sabre_laser (1312)
Seat 8: Franz1317 (1215)
Seat 9: thiga69 (6853)
*** ANTE/BLINDS ***
Franz1317 posts ante 20
thiga69 posts ante 20
rosti900 posts ante 20
doopy00 posts ante 20
sabre_laser posts ante 20
Franz1317 posts small blind 150
thiga69 posts big blind 300
Dealt to sabre_laser [2d 6h]
*** PRE-FLOP *** 
rosti900 folds
doopy00 raises 1580 to 1880 and is all-in
sabre_laser folds
Franz1317 folds
thiga69 folds
doopy00 collected 2430 from pot
*** SUMMARY ***
Total pot 2430 | No rake
Seat 5: doopy00 won 2430


Winamax Poker - Tournament "No Limit Hold'em" buyIn: 0,45€ + 0,05€ level: 8 - HandId: #445588443049754625-61-1418856774 - Holdem no limit (20/150/300) - 2014/12/17 22:52:54 UTC
Table: 'No Limit Hold'em(103746644)#0' 10-max (real money) Seat #8 is the button
Seat 1: rosti900 (3700)
Seat 5: doopy00 (2430)
Seat 6: sabre_laser (1292)
Seat 8: Franz1317 (1045)
Seat 9: thiga69 (6533)
*** ANTE/BLINDS ***
thiga69 posts ante 20
rosti900 posts ante 20
doopy00 posts ante 20
sabre_laser posts ante 20
Franz1317 posts ante 20
thiga69 posts small blind 150
rosti900 posts big blind 300
Dealt to sabre_laser [4h 3s]
*** PRE-FLOP *** 
doopy00 folds
sabre_laser folds
Franz1317 raises 725 to 1025 and is all-in
thiga69 folds
rosti900 calls 725
*** FLOP *** [Jc 7d 6c]
*** TURN *** [Jc 7d 6c][Jd]
*** RIVER *** [Jc 7d 6c Jd][9d]
*** SHOW DOWN ***
Franz1317 shows [As 9s] (Two pairs : Jacks and 9)
rosti900 shows [Jh Ks] (Trips of Jacks)
rosti900 collected 2300 from pot
*** SUMMARY ***
Total pot 2300 | No rake
Board: [Jc 7d 6c Jd 9d]
Seat 1: rosti900 (big blind) showed [Jh Ks] and won 2300 with Trips of Jacks
Seat 8: Franz1317 (button) showed [As 9s] and lost with Two pairs : Jacks and 9


Winamax Poker - Tournament "No Limit Hold'em" buyIn: 0,45€ + 0,05€ level: 8 - HandId: #445588443049754625-62-1418856793 - Holdem no limit (20/150/300) - 2014/12/17 22:53:13 UTC
Table: 'No Limit Hold'em(103746644)#0' 10-max (real money) Seat #9 is the button
Seat 1: rosti900 (4955)
Seat 5: doopy00 (2410)
Seat 6: sabre_laser (1272)
Seat 9: thiga69 (6363)
*** ANTE/BLINDS ***
rosti900 posts ante 20
doopy00 posts ante 20
sabre_laser posts ante 20
thiga69 posts ante 20
rosti900 posts small blind 150
doopy00 posts big blind 300
Dealt to sabre_laser [Qc Qd]
*** PRE-FLOP *** 
sabre_laser calls 300
thiga69 folds
rosti900 folds
doopy00 raises 2090 to 2390 and is all-in
sabre_laser calls 952 and is all-in
*** FLOP *** [8c Ks 3c]
*** TURN *** [8c Ks 3c][Ts]
*** RIVER *** [8c Ks 3c Ts][Jc]
*** SHOW DOWN ***
sabre_laser shows [Qc Qd] (One pair : Queens)
doopy00 shows [Jd Js] (Trips of Jacks)
doopy00 collected 3872 from pot
*** SUMMARY ***
Total pot 3872 | No rake
Board: [8c Ks 3c Ts Jc]
Seat 5: doopy00 (big blind) showed [Jd Js] and won 3872 with Trips of Jacks
Seat 6: sabre_laser showed [Qc Qd] and lost with One pair : Queens


