Winamax Poker - CashGame - HandId: #7336148-2511-1427479020 - Holdem no limit (0.01€/0.02€) - 2015/03/27 17:57:00 UTC
Table: 'Frankfurt 03' 9-max (real money) Seat #6 is the button
Seat 1: Nuts... (2.01€)
Seat 2: CHOUKINAWA (0.98€)
Seat 3: xxcresusxx62 (2.03€)
Seat 4: sabre_laser (2€)
Seat 5: WaldoGeraldo (1.99€)
Seat 6: Gauth7 (3.10€)
Seat 7: rick91 (1.66€)
Seat 8: fleurdel0tus (2€)
Seat 9: Mecheblanche (2.25€)
*** ANTE/BLINDS ***
rick91 posts small blind 0.01€
fleurdel0tus posts big blind 0.02€
sabre_laser posts big blind 0.02€ out of position
Dealt to sabre_laser [Ks 6s]
*** PRE-FLOP *** 
Mecheblanche folds
Nuts... folds
CHOUKINAWA folds
sabre_laser raises 0.03€ to 0.05€
WaldoGeraldo folds
Gauth7 folds
rick91 folds
fleurdel0tus folds
sabre_laser collected 0.08€ from pot
*** SUMMARY ***
Total pot 0.08€ | No rake
Seat 4: sabre_laser won 0.08€


Winamax Poker - CashGame - HandId: #7336148-2512-1427479040 - Holdem no limit (0.01€/0.02€) - 2015/03/27 17:57:20 UTC
Table: 'Frankfurt 03' 9-max (real money) Seat #7 is the button
Seat 1: Nuts... (2.01€)
Seat 2: CHOUKINAWA (0.98€)
Seat 3: xxcresusxx62 (2.03€)
Seat 4: sabre_laser (2.03€)
Seat 5: WaldoGeraldo (1.99€)
Seat 6: Gauth7 (3.10€)
Seat 7: rick91 (1.65€)
Seat 8: fleurdel0tus (2€)
Seat 9: Mecheblanche (2.25€)
*** ANTE/BLINDS ***
fleurdel0tus posts small blind 0.01€
Mecheblanche posts big blind 0.02€
Dealt to sabre_laser [3h Qs]
*** PRE-FLOP *** 
Nuts... folds
CHOUKINAWA raises 0.03€ to 0.05€
sabre_laser folds
WaldoGeraldo folds
Gauth7 folds
rick91 calls 0.05€
fleurdel0tus folds
Mecheblanche folds
*** FLOP *** [5d 9c 2h]
CHOUKINAWA bets 0.22€
rick91 folds
CHOUKINAWA collected 0.34€ from pot
*** SUMMARY ***
Total pot 0.34€ | Rake 0.01€
Board: [5d 9c 2h]
Seat 2: CHOUKINAWA won 0.34€


Winamax Poker - CashGame - HandId: #7336148-2513-1427479087 - Holdem no limit (0.01€/0.02€) - 2015/03/27 17:58:07 UTC
Table: 'Frankfurt 03' 9-max (real money) Seat #8 is the button
Seat 1: Nuts... (2.01€)
Seat 2: CHOUKINAWA (1.05€)
Seat 3: xxcresusxx62 (2.03€)
Seat 4: sabre_laser (2.03€)
Seat 5: WaldoGeraldo (1.99€)
Seat 6: Gauth7 (3.10€)
Seat 7: rick91 (1.60€)
Seat 8: fleurdel0tus (2€)
Seat 9: Mecheblanche (2.23€)
*** ANTE/BLINDS ***
Mecheblanche posts small blind 0.01€
Nuts... posts big blind 0.02€
Dealt to sabre_laser [9c Td]
*** PRE-FLOP *** 
CHOUKINAWA raises 0.03€ to 0.05€
sabre_laser folds
WaldoGeraldo folds
Gauth7 folds
rick91 folds
fleurdel0tus folds
Mecheblanche folds
Nuts... raises 1.96€ to 2.01€ and is all-in
CHOUKINAWA calls 1€ and is all-in
*** FLOP *** [4h Kh 3s]
*** TURN *** [4h Kh 3s][Kc]
*** RIVER *** [4h Kh 3s Kc][Js]
*** SHOW DOWN ***
CHOUKINAWA shows [Qd Ts] (One pair : Kings)
Nuts... shows [Qc Qh] (Two pairs : Kings and Queens)
Nuts... collected 2.93€ from pot
*** SUMMARY ***
Total pot 2.93€ | Rake 0.14€
Board: [4h Kh 3s Kc Js]
Seat 1: Nuts... (big blind) showed [Qc Qh] and won 2.93€ with Two pairs : Kings and Queens
Seat 2: CHOUKINAWA showed [Qd Ts] and lost with One pair : Kings


Winamax Poker - CashGame - HandId: #7336148-2514-1427479123 - Holdem no limit (0.01€/0.02€) - 2015/03/27 17:58:43 UTC
Table: 'Frankfurt 03' 9-max (real money) Seat #9 is the button
Seat 1: Nuts... (2.93€)
Seat 2: CHOUKINAWA (0€)
Seat 3: xxcresusxx62 (2.03€)
Seat 4: sabre_laser (2.03€)
Seat 5: WaldoGeraldo (1.99€)
Seat 6: Gauth7 (3.10€)
Seat 7: rick91 (1.60€)
Seat 8: fleurdel0tus (2€)
Seat 9: Mecheblanche (2.22€)
*** ANTE/BLINDS ***
Nuts... posts small blind 0.01€
sabre_laser posts big blind 0.02€
Dealt to sabre_laser [6s Jh]
*** PRE-FLOP *** 
WaldoGeraldo folds
Gauth7 folds
rick91 folds
fleurdel0tus folds
Mecheblanche folds
Nuts... folds
sabre_laser collected 0.03€ from pot
*** SUMMARY ***
Total pot 0.03€ | No rake
Seat 4: sabre_laser (big blind) won 0.03€


Winamax Poker - CashGame - HandId: #7336148-2515-1427479146 - Holdem no limit (0.01€/0.02€) - 2015/03/27 17:59:06 UTC
Table: 'Frankfurt 03' 9-max (real money) Seat #1 is the button
Seat 1: Nuts... (2.92€)
Seat 2: titistrg (2€)
Seat 3: xxcresusxx62 (2.03€)
Seat 4: sabre_laser (2.04€)
Seat 5: WaldoGeraldo (1.99€)
Seat 6: Gauth7 (3.10€)
Seat 7: rick91 (1.60€)
Seat 8: fleurdel0tus (2€)
Seat 9: Mecheblanche (2.22€)
*** ANTE/BLINDS ***
sabre_laser posts small blind 0.01€
WaldoGeraldo posts big blind 0.02€
Dealt to sabre_laser [6c Th]
*** PRE-FLOP *** 
Gauth7 raises 0.04€ to 0.06€
rick91 folds
fleurdel0tus folds
Mecheblanche folds
Nuts... folds
sabre_laser folds
WaldoGeraldo calls 0.04€
*** FLOP *** [Jd 7h 8h]
WaldoGeraldo checks
Gauth7 bets 0.07€
WaldoGeraldo folds
Gauth7 collected 0.19€ from pot
*** SUMMARY ***
Total pot 0.19€ | Rake 0.01€
Board: [Jd 7h 8h]
Seat 6: Gauth7 won 0.19€


Winamax Poker - CashGame - HandId: #7336148-2516-1427479206 - Holdem no limit (0.01€/0.02€) - 2015/03/27 18:00:06 UTC
Table: 'Frankfurt 03' 9-max (real money) Seat #4 is the button
Seat 1: Nuts... (2.92€)
Seat 2: titistrg (2€)
Seat 3: xxcresusxx62 (2.03€)
Seat 4: sabre_laser (2.03€)
Seat 5: WaldoGeraldo (2€)
Seat 6: Gauth7 (3.16€)
Seat 7: rick91 (1.60€)
Seat 8: fleurdel0tus (2€)
Seat 9: Mecheblanche (2.22€)
*** ANTE/BLINDS ***
Gauth7 denies big blind
WaldoGeraldo posts small blind 0.01€
rick91 posts big blind 0.02€
Dealt to sabre_laser [9c 5d]
*** PRE-FLOP *** 
fleurdel0tus folds
Mecheblanche folds
Nuts... folds
sabre_laser folds
WaldoGeraldo folds
rick91 collected 0.03€ from pot
*** SUMMARY ***
Total pot 0.03€ | No rake
Seat 7: rick91 (big blind) won 0.03€


Winamax Poker - CashGame - HandId: #7336148-2517-1427479233 - Holdem no limit (0.01€/0.02€) - 2015/03/27 18:00:33 UTC
Table: 'Frankfurt 03' 9-max (real money) Seat #5 is the button
Seat 1: Nuts... (2.92€)
Seat 2: titistrg (2€)
Seat 3: xxcresusxx62 (2.03€)
Seat 4: sabre_laser (2.03€)
Seat 5: WaldoGeraldo (1.99€)
Seat 6: kalinka59230 (2€)
Seat 7: rick91 (1.61€)
Seat 8: fleurdel0tus (2€)
Seat 9: Mecheblanche (2.22€)
*** ANTE/BLINDS ***
fleurdel0tus denies big blind
rick91 posts small blind 0.01€
Mecheblanche posts big blind 0.02€
titistrg posts big blind 0.02€ out of position
Dealt to sabre_laser [9d 2h]
*** PRE-FLOP *** 
titistrg checks
sabre_laser folds
WaldoGeraldo folds
rick91 calls 0.01€
Mecheblanche checks
*** FLOP *** [3s Ah 8d]
rick91 checks
Mecheblanche checks
titistrg bets 0.06€
rick91 folds
Mecheblanche folds
titistrg collected 0.12€ from pot
*** SUMMARY ***
Total pot 0.12€ | No rake
Board: [3s Ah 8d]
Seat 2: titistrg won 0.12€


Winamax Poker - CashGame - HandId: #7336148-2518-1427479276 - Holdem no limit (0.01€/0.02€) - 2015/03/27 18:01:16 UTC
Table: 'Frankfurt 03' 9-max (real money) Seat #7 is the button
Seat 1: Nuts... (2.92€)
Seat 2: titistrg (2.04€)
Seat 3: xxcresusxx62 (2.03€)
Seat 4: sabre_laser (2.03€)
Seat 5: WaldoGeraldo (1.99€)
Seat 6: kalinka59230 (2€)
Seat 7: rick91 (1.59€)
Seat 8: jannot1986 (1.04€)
Seat 9: Mecheblanche (2.20€)
*** ANTE/BLINDS ***
Mecheblanche posts small blind 0.01€
titistrg posts big blind 0.02€
kalinka59230 posts big blind 0.02€ out of position
Dealt to sabre_laser [9s Tc]
*** PRE-FLOP *** 
sabre_laser folds
WaldoGeraldo raises 0.08€ to 0.10€
kalinka59230 folds
rick91 folds
Mecheblanche folds
titistrg folds
WaldoGeraldo collected 0.15€ from pot
*** SUMMARY ***
Total pot 0.15€ | No rake
Seat 5: WaldoGeraldo won 0.15€


Winamax Poker - CashGame - HandId: #7336148-2519-1427479301 - Holdem no limit (0.01€/0.02€) - 2015/03/27 18:01:41 UTC
Table: 'Frankfurt 03' 9-max (real money) Seat #9 is the button
Seat 1: Nuts... (2.92€)
Seat 2: titistrg (2.02€)
Seat 4: sabre_laser (2.03€)
Seat 5: WaldoGeraldo (2.04€)
Seat 6: kalinka59230 (1.98€)
Seat 7: rick91 (1.59€)
Seat 8: jannot1986 (1.04€)
Seat 9: Mecheblanche (2.19€)
*** ANTE/BLINDS ***
titistrg posts small blind 0.01€
sabre_laser posts big blind 0.02€
jannot1986 posts big blind 0.02€ out of position
Dealt to sabre_laser [Qh 3c]
*** PRE-FLOP *** 
WaldoGeraldo folds
kalinka59230 folds
rick91 calls 0.02€
jannot1986 checks
Mecheblanche raises 0.04€ to 0.06€
titistrg folds
sabre_laser folds
rick91 calls 0.04€
jannot1986 folds
*** FLOP *** [As 6d Ac]
rick91 checks
Mecheblanche checks
*** TURN *** [As 6d Ac][9d]
rick91 checks
Mecheblanche checks
*** RIVER *** [As 6d Ac 9d][Kc]
rick91 bets 0.18€
Mecheblanche folds
rick91 collected 0.34€ from pot
*** SUMMARY ***
Total pot 0.34€ | Rake 0.01€
Board: [As 6d Ac 9d Kc]
Seat 7: rick91 won 0.34€


Winamax Poker - CashGame - HandId: #7336148-2520-1427479371 - Holdem no limit (0.01€/0.02€) - 2015/03/27 18:02:51 UTC
Table: 'Frankfurt 03' 9-max (real money) Seat #2 is the button
Seat 1: momoclonney (2€)
Seat 2: titistrg (2.01€)
Seat 3: Nightbreed (2€)
Seat 4: sabre_laser (2.01€)
Seat 5: WaldoGeraldo (2.04€)
Seat 6: kalinka59230 (1.98€)
Seat 7: rick91 (1.69€)
Seat 8: jannot1986 (1.02€)
Seat 9: Mecheblanche (2.13€)
*** ANTE/BLINDS ***
sabre_laser posts small blind 0.01€
WaldoGeraldo posts big blind 0.02€
momoclonney posts big blind 0.02€ out of position
Dealt to sabre_laser [Ts 6c]
*** PRE-FLOP *** 
kalinka59230 folds
rick91 calls 0.02€
jannot1986 folds
Mecheblanche folds
momoclonney checks
titistrg calls 0.02€
sabre_laser calls 0.01€
WaldoGeraldo checks
*** FLOP *** [Qs 2d 4d]
sabre_laser checks
WaldoGeraldo checks
rick91 checks
momoclonney checks
titistrg checks
*** TURN *** [Qs 2d 4d][8c]
sabre_laser checks
WaldoGeraldo checks
rick91 checks
momoclonney checks
titistrg checks
*** RIVER *** [Qs 2d 4d 8c][Jd]
sabre_laser checks
WaldoGeraldo checks
rick91 checks
momoclonney checks
titistrg checks
*** SHOW DOWN ***
titistrg shows [6s 3s] (High card : Queen)
sabre_laser shows [Ts 6c] (High card : Queen)
WaldoGeraldo shows [3d Tc] (High card : Queen)
momoclonney shows [Ah 5h] (High card : Ace)
rick91 shows [5s As] (High card : Ace)
rick91 collected 0.05€ from pot
momoclonney collected 0.04€ from pot
*** SUMMARY ***
Total pot 0.09€ | Rake 0.01€
Board: [Qs 2d 4d 8c Jd]
Seat 1: momoclonney showed [Ah 5h] and won 0.04€ with High card : Ace
Seat 2: titistrg (button) showed [6s 3s] and lost with High card : Queen
Seat 4: sabre_laser (small blind) showed [Ts 6c] and lost with High card : Queen
Seat 5: WaldoGeraldo (big blind) showed [3d Tc] and lost with High card : Queen
Seat 7: rick91 showed [5s As] and won 0.05€ with High card : Ace


Winamax Poker - CashGame - HandId: #7336148-2521-1427479441 - Holdem no limit (0.01€/0.02€) - 2015/03/27 18:04:01 UTC
Table: 'Frankfurt 03' 9-max (real money) Seat #4 is the button
Seat 1: momoclonney (2.02€)
Seat 2: titistrg (1.99€)
Seat 3: Nightbreed (2€)
Seat 4: sabre_laser (1.99€)
Seat 5: WaldoGeraldo (2.02€)
Seat 6: kalinka59230 (1.98€)
Seat 7: rick91 (1.72€)
Seat 8: jannot1986 (1.02€)
Seat 9: Mecheblanche (2.13€)
*** ANTE/BLINDS ***
WaldoGeraldo posts small blind 0.01€
kalinka59230 posts big blind 0.02€
Dealt to sabre_laser [9h 9d]
*** PRE-FLOP *** 
rick91 folds
jannot1986 calls 0.02€
Mecheblanche folds
momoclonney folds
titistrg folds
sabre_laser raises 0.08€ to 0.10€
WaldoGeraldo folds
kalinka59230 folds
jannot1986 calls 0.08€
*** FLOP *** [Jh Kd Qd]
jannot1986 checks
sabre_laser bets 0.06€
jannot1986 calls 0.06€
*** TURN *** [Jh Kd Qd][5h]
jannot1986 checks
sabre_laser checks
*** RIVER *** [Jh Kd Qd 5h][5c]
jannot1986 bets 0.18€
sabre_laser folds
jannot1986 collected 0.51€ from pot
*** SUMMARY ***
Total pot 0.51€ | Rake 0.02€
Board: [Jh Kd Qd 5h 5c]
Seat 8: jannot1986 won 0.51€


Winamax Poker - CashGame - HandId: #7336148-2522-1427479536 - Holdem no limit (0.01€/0.02€) - 2015/03/27 18:05:36 UTC
Table: 'Frankfurt 03' 9-max (real money) Seat #5 is the button
Seat 1: momoclonney (2.02€)
Seat 2: titistrg (1.99€)
Seat 3: Nightbreed (2€)
Seat 4: sabre_laser (1.83€)
Seat 5: WaldoGeraldo (2.01€)
Seat 6: kalinka59230 (1.96€)
Seat 7: rick91 (1.72€)
Seat 8: jannot1986 (1.19€)
Seat 9: Mecheblanche (2.13€)
*** ANTE/BLINDS ***
kalinka59230 posts small blind 0.01€
rick91 posts big blind 0.02€
Dealt to sabre_laser [7h 6h]
*** PRE-FLOP *** 
jannot1986 folds
Mecheblanche folds
momoclonney folds
titistrg folds
sabre_laser calls 0.02€
WaldoGeraldo folds
kalinka59230 folds
rick91 checks
*** FLOP *** [Kc 5s 7s]
rick91 checks
sabre_laser bets 0.04€
rick91 folds
sabre_laser collected 0.09€ from pot
*** SUMMARY ***
Total pot 0.09€ | No rake
Board: [Kc 5s 7s]
Seat 4: sabre_laser won 0.09€


Winamax Poker - CashGame - HandId: #7336148-2523-1427479587 - Holdem no limit (0.01€/0.02€) - 2015/03/27 18:06:27 UTC
Table: 'Frankfurt 03' 9-max (real money) Seat #6 is the button
Seat 1: momoclonney (2.02€)
Seat 2: titistrg (1.99€)
Seat 3: Nightbreed (2€)
Seat 4: sabre_laser (1.86€)
Seat 5: WaldoGeraldo (2.01€)
Seat 6: kalinka59230 (1.95€)
Seat 7: rick91 (1.70€)
Seat 8: jannot1986 (1.19€)
Seat 9: Mecheblanche (2.13€)
*** ANTE/BLINDS ***
rick91 posts small blind 0.01€
jannot1986 posts big blind 0.02€
Dealt to sabre_laser [Ts 8c]
*** PRE-FLOP *** 
Mecheblanche folds
momoclonney calls 0.02€
titistrg folds
sabre_laser folds
WaldoGeraldo folds
kalinka59230 folds
rick91 raises 0.02€ to 0.04€
jannot1986 folds
momoclonney calls 0.02€
*** FLOP *** [5d 4d 5s]
rick91 bets 0.02€
momoclonney calls 0.02€
*** TURN *** [5d 4d 5s][6h]
rick91 bets 0.02€
momoclonney calls 0.02€
*** RIVER *** [5d 4d 5s 6h][3d]
rick91 bets 0.02€
momoclonney calls 0.02€
*** SHOW DOWN ***
momoclonney shows [Ac 9h] (One pair : 5)
rick91 shows [Qh Ad] (One pair : 5)
rick91 collected 0.21€ from pot
*** SUMMARY ***
Total pot 0.21€ | Rake 0.01€
Board: [5d 4d 5s 6h 3d]
Seat 1: momoclonney showed [Ac 9h] and lost with One pair : 5
Seat 7: rick91 (small blind) showed [Qh Ad] and won 0.21€ with One pair : 5


Winamax Poker - CashGame - HandId: #7336148-2524-1427479688 - Holdem no limit (0.01€/0.02€) - 2015/03/27 18:08:08 UTC
Table: 'Frankfurt 03' 9-max (real money) Seat #7 is the button
Seat 1: momoclonney (1.92€)
Seat 2: titistrg (1.99€)
Seat 3: Nightbreed (2€)
Seat 4: sabre_laser (1.86€)
Seat 5: WaldoGeraldo (2.01€)
Seat 6: kalinka59230 (1.95€)
Seat 7: rick91 (1.81€)
Seat 8: jannot1986 (1.17€)
Seat 9: Mecheblanche (2.13€)
*** ANTE/BLINDS ***
jannot1986 posts small blind 0.01€
Mecheblanche posts big blind 0.02€
Dealt to sabre_laser [6d 2d]
*** PRE-FLOP *** 
momoclonney folds
titistrg folds
sabre_laser folds
WaldoGeraldo folds
kalinka59230 calls 0.02€
rick91 folds
jannot1986 calls 0.01€
Mecheblanche checks
*** FLOP *** [Kd Qs 2c]
jannot1986 checks
Mecheblanche checks
kalinka59230 checks
*** TURN *** [Kd Qs 2c][5d]
jannot1986 checks
Mecheblanche bets 0.04€
kalinka59230 folds
jannot1986 folds
Mecheblanche collected 0.10€ from pot
*** SUMMARY ***
Total pot 0.10€ | No rake
Board: [Kd Qs 2c 5d]
Seat 9: Mecheblanche (big blind) won 0.10€


Winamax Poker - CashGame - HandId: #7336148-2525-1427479752 - Holdem no limit (0.01€/0.02€) - 2015/03/27 18:09:12 UTC
Table: 'Frankfurt 03' 9-max (real money) Seat #8 is the button
Seat 1: momoclonney (1.92€)
Seat 2: titistrg (1.99€)
Seat 3: Nightbreed (2€)
Seat 4: sabre_laser (1.86€)
Seat 5: WaldoGeraldo (2.01€)
Seat 6: kalinka59230 (1.93€)
Seat 7: rick91 (1.81€)
Seat 8: jannot1986 (1.15€)
Seat 9: Mecheblanche (2.17€)
*** ANTE/BLINDS ***
Mecheblanche posts small blind 0.01€
momoclonney posts big blind 0.02€
Dealt to sabre_laser [Ts 5d]
*** PRE-FLOP *** 
titistrg folds
sabre_laser folds
WaldoGeraldo folds
kalinka59230 folds
rick91 raises 0.02€ to 0.04€
jannot1986 folds
Mecheblanche calls 0.03€
momoclonney calls 0.02€
*** FLOP *** [Ac Kd 9c]
Mecheblanche checks
momoclonney checks
rick91 bets 0.07€
Mecheblanche raises 0.15€ to 0.22€
momoclonney calls 0.22€
rick91 folds
*** TURN *** [Ac Kd 9c][Ah]
Mecheblanche bets 0.21€
momoclonney calls 0.21€
*** RIVER *** [Ac Kd 9c Ah][5h]
Mecheblanche bets 0.55€
momoclonney calls 0.55€
*** SHOW DOWN ***
momoclonney shows [Qd Ks] (Two pairs : Aces and Kings)
Mecheblanche shows [9s 9d] (Full of 9 and Aces)
Mecheblanche collected 2.01€ from pot
*** SUMMARY ***
Total pot 2.01€ | Rake 0.14€
Board: [Ac Kd 9c Ah 5h]
Seat 1: momoclonney (big blind) showed [Qd Ks] and lost with Two pairs : Aces and Kings
Seat 9: Mecheblanche (small blind) showed [9s 9d] and won 2.01€ with Full of 9 and Aces


Winamax Poker - CashGame - HandId: #7336148-2526-1427479832 - Holdem no limit (0.01€/0.02€) - 2015/03/27 18:10:32 UTC
Table: 'Frankfurt 03' 9-max (real money) Seat #9 is the button
Seat 1: momoclonney (0.90€)
Seat 2: titistrg (1.99€)
Seat 3: Nightbreed (2€)
Seat 4: sabre_laser (1.86€)
Seat 5: WaldoGeraldo (2.01€)
Seat 6: kalinka59230 (1.93€)
Seat 7: rick91 (1.70€)
Seat 8: jannot1986 (1.15€)
Seat 9: Mecheblanche (3.16€)
*** ANTE/BLINDS ***
momoclonney posts small blind 0.01€
titistrg posts big blind 0.02€
Dealt to sabre_laser [3c 4d]
*** PRE-FLOP *** 
sabre_laser folds
WaldoGeraldo folds
kalinka59230 folds
rick91 folds
jannot1986 folds
Mecheblanche folds
momoclonney folds
titistrg collected 0.03€ from pot
*** SUMMARY ***
Total pot 0.03€ | No rake
Seat 2: titistrg (big blind) won 0.03€


Winamax Poker - CashGame - HandId: #7336148-2527-1427479861 - Holdem no limit (0.01€/0.02€) - 2015/03/27 18:11:01 UTC
Table: 'Frankfurt 03' 9-max (real money) Seat #1 is the button
Seat 1: momoclonney (0.89€)
Seat 2: titistrg (2€)
Seat 3: Nightbreed (2€)
Seat 4: sabre_laser (1.86€)
Seat 5: WaldoGeraldo (2.01€)
Seat 6: kalinka59230 (1.93€)
Seat 7: rick91 (1.70€)
Seat 8: jannot1986 (1.15€)
Seat 9: Mecheblanche (3.16€)
*** ANTE/BLINDS ***
titistrg posts small blind 0.01€
Nightbreed posts big blind 0.02€
Dealt to sabre_laser [7d 7s]
*** PRE-FLOP *** 
sabre_laser calls 0.02€
WaldoGeraldo folds
kalinka59230 folds
rick91 folds
jannot1986 folds
Mecheblanche folds
momoclonney folds
titistrg folds
Nightbreed checks
*** FLOP *** [Tc Jc Qc]
Nightbreed checks
sabre_laser bets 0.03€
Nightbreed folds
sabre_laser collected 0.08€ from pot
*** SUMMARY ***
Total pot 0.08€ | No rake
Board: [Tc Jc Qc]
Seat 4: sabre_laser won 0.08€


Winamax Poker - CashGame - HandId: #7336148-2528-1427479903 - Holdem no limit (0.01€/0.02€) - 2015/03/27 18:11:43 UTC
Table: 'Frankfurt 03' 9-max (real money) Seat #2 is the button
Seat 1: momoclonney (0.89€)
Seat 2: titistrg (1.99€)
Seat 3: Nightbreed (2€)
Seat 4: sabre_laser (1.89€)
Seat 5: WaldoGeraldo (2.01€)
Seat 6: kalinka59230 (1.93€)
Seat 7: rick91 (1.70€)
Seat 8: jannot1986 (1.15€)
Seat 9: Mecheblanche (3.16€)
*** ANTE/BLINDS ***
Nightbreed posts small blind 0.01€
sabre_laser posts big blind 0.02€
Dealt to sabre_laser [Qs 6h]
*** PRE-FLOP *** 
WaldoGeraldo folds
kalinka59230 folds
rick91 folds
jannot1986 folds
Mecheblanche folds
momoclonney folds
titistrg folds
Nightbreed raises 0.04€ to 0.06€
sabre_laser calls 0.04€
*** FLOP *** [Td 5d 6c]
Nightbreed bets 0.06€
sabre_laser raises 1.77€ to 1.83€ and is all-in
Nightbreed folds
sabre_laser collected 1.99€ from pot
*** SUMMARY ***
Total pot 1.99€ | Rake 0.02€
Board: [Td 5d 6c]
Seat 4: sabre_laser (big blind) won 1.99€


Winamax Poker - CashGame - HandId: #7336148-2529-1427479953 - Holdem no limit (0.01€/0.02€) - 2015/03/27 18:12:33 UTC
Table: 'Frankfurt 03' 9-max (real money) Seat #3 is the button
Seat 1: fran cky (2€)
Seat 2: titistrg (1.99€)
Seat 3: Nightbreed (2€)
Seat 4: sabre_laser (1.99€)
Seat 5: WaldoGeraldo (2.01€)
Seat 6: kalinka59230 (1.93€)
Seat 7: rick91 (1.70€)
Seat 8: jannot1986 (1.15€)
Seat 9: Mecheblanche (3.16€)
*** ANTE/BLINDS ***
sabre_laser posts small blind 0.01€
WaldoGeraldo posts big blind 0.02€
fran cky posts big blind 0.02€ out of position
Dealt to sabre_laser [Jc Tc]
*** PRE-FLOP *** 
kalinka59230 folds
rick91 folds
jannot1986 folds
Mecheblanche folds
fran cky checks
titistrg folds
Nightbreed folds
sabre_laser calls 0.01€
WaldoGeraldo checks
*** FLOP *** [9s 3h 6h]
sabre_laser checks
WaldoGeraldo checks
fran cky checks
*** TURN *** [9s 3h 6h][8c]
sabre_laser checks
WaldoGeraldo checks
fran cky checks
*** RIVER *** [9s 3h 6h 8c][8s]
sabre_laser checks
WaldoGeraldo checks
fran cky checks
*** SHOW DOWN ***
fran cky shows [Jh 7d] (One pair : 8)
sabre_laser shows [Jc Tc] (One pair : 8)
WaldoGeraldo shows [2d Ah] (One pair : 8)
WaldoGeraldo collected 0.06€ from pot
*** SUMMARY ***
Total pot 0.06€ | No rake
Board: [9s 3h 6h 8c 8s]
Seat 1: fran cky showed [Jh 7d] and lost with One pair : 8
Seat 4: sabre_laser (small blind) showed [Jc Tc] and lost with One pair : 8
Seat 5: WaldoGeraldo (big blind) showed [2d Ah] and won 0.06€ with One pair : 8


Winamax Poker - CashGame - HandId: #7336148-2530-1427480048 - Holdem no limit (0.01€/0.02€) - 2015/03/27 18:14:08 UTC
Table: 'Frankfurt 03' 9-max (real money) Seat #4 is the button
Seat 1: fran cky (1.98€)
Seat 2: titistrg (1.99€)
Seat 3: Nightbreed (2€)
Seat 4: sabre_laser (1.97€)
Seat 5: WaldoGeraldo (2.05€)
Seat 6: kalinka59230 (1.93€)
Seat 7: rick91 (1.70€)
Seat 8: jannot1986 (1.15€)
Seat 9: Mecheblanche (3.16€)
*** ANTE/BLINDS ***
WaldoGeraldo posts small blind 0.01€
kalinka59230 posts big blind 0.02€
Dealt to sabre_laser [As 2h]
*** PRE-FLOP *** 
rick91 raises 0.02€ to 0.04€
jannot1986 folds
Mecheblanche folds
fran cky folds
titistrg folds
Nightbreed folds
sabre_laser folds
WaldoGeraldo calls 0.03€
kalinka59230 folds
*** FLOP *** [7s 9c Kh]
WaldoGeraldo checks
rick91 bets 0.02€
WaldoGeraldo folds
rick91 collected 0.11€ from pot
*** SUMMARY ***
Total pot 0.11€ | Rake 0.01€
Board: [7s 9c Kh]
Seat 7: rick91 won 0.11€


Winamax Poker - CashGame - HandId: #7336148-2531-1427480074 - Holdem no limit (0.01€/0.02€) - 2015/03/27 18:14:34 UTC
Table: 'Frankfurt 03' 9-max (real money) Seat #5 is the button
Seat 1: fran cky (1.98€)
Seat 2: titistrg (1.99€)
Seat 3: Nightbreed (2€)
Seat 4: sabre_laser (1.97€)
Seat 5: WaldoGeraldo (2.01€)
Seat 6: kalinka59230 (1.91€)
Seat 7: rick91 (1.75€)
Seat 8: foalinaah (0€)
Seat 9: Mecheblanche (3.16€)
*** ANTE/BLINDS ***
kalinka59230 posts small blind 0.01€
rick91 posts big blind 0.02€
Dealt to sabre_laser [8d 6s]
*** PRE-FLOP *** 
Mecheblanche calls 0.02€
fran cky folds
titistrg folds
Nightbreed folds
sabre_laser folds
WaldoGeraldo folds
kalinka59230 folds
rick91 checks
*** FLOP *** [Kd Qh As]
rick91 checks
Mecheblanche bets 0.03€
rick91 folds
Mecheblanche collected 0.08€ from pot
*** SUMMARY ***
Total pot 0.08€ | No rake
Board: [Kd Qh As]
Seat 9: Mecheblanche won 0.08€


Winamax Poker - CashGame - HandId: #7336148-2532-1427480121 - Holdem no limit (0.01€/0.02€) - 2015/03/27 18:15:21 UTC
Table: 'Frankfurt 03' 9-max (real money) Seat #6 is the button
Seat 1: fran cky (1.98€)
Seat 2: titistrg (1.99€)
Seat 3: Nightbreed (2€)
Seat 4: sabre_laser (1.97€)
Seat 5: WaldoGeraldo (2.01€)
Seat 6: kalinka59230 (1.90€)
Seat 7: rick91 (1.73€)
Seat 8: foalinaah (2€)
Seat 9: Mecheblanche (3.19€)
*** ANTE/BLINDS ***
rick91 posts small blind 0.01€
foalinaah posts big blind 0.02€
Dealt to sabre_laser [Jc 7d]
*** PRE-FLOP *** 
Mecheblanche calls 0.02€
fran cky folds
titistrg folds
Nightbreed folds
sabre_laser folds
WaldoGeraldo folds
kalinka59230 folds
rick91 calls 0.01€
foalinaah checks
*** FLOP *** [8c Kc 5s]
rick91 checks
foalinaah checks
Mecheblanche checks
*** TURN *** [8c Kc 5s][7h]
rick91 checks
foalinaah checks
Mecheblanche checks
*** RIVER *** [8c Kc 5s 7h][2h]
rick91 checks
foalinaah checks
Mecheblanche checks
*** SHOW DOWN ***
foalinaah shows [8d 6s] (One pair : 8)
Mecheblanche shows [As Qd] (High card : Ace)
rick91 shows [Td 8h] (One pair : 8)
rick91 collected 0.06€ from pot
*** SUMMARY ***
Total pot 0.06€ | No rake
Board: [8c Kc 5s 7h 2h]
Seat 7: rick91 (small blind) showed [Td 8h] and won 0.06€ with One pair : 8
Seat 8: foalinaah (big blind) showed [8d 6s] and lost with One pair : 8
Seat 9: Mecheblanche showed [As Qd] and lost with High card : Ace


Winamax Poker - CashGame - HandId: #7336148-2533-1427480189 - Holdem no limit (0.01€/0.02€) - 2015/03/27 18:16:29 UTC
Table: 'Frankfurt 03' 9-max (real money) Seat #7 is the button
Seat 1: fran cky (1.98€)
Seat 2: titistrg (1.99€)
Seat 3: Nightbreed (2€)
Seat 4: sabre_laser (1.97€)
Seat 5: WaldoGeraldo (2.01€)
Seat 6: kalinka59230 (1.90€)
Seat 7: rick91 (1.77€)
Seat 8: foalinaah (2€)
Seat 9: Mecheblanche (3.17€)
*** ANTE/BLINDS ***
foalinaah posts small blind 0.01€
Mecheblanche posts big blind 0.02€
Dealt to sabre_laser [Ts 8c]
*** PRE-FLOP *** 
fran cky folds
titistrg calls 0.02€
Nightbreed folds
sabre_laser folds
WaldoGeraldo folds
kalinka59230 folds
rick91 folds
foalinaah folds
Mecheblanche checks
*** FLOP *** [Ad 3d 3c]
Mecheblanche checks
titistrg checks
*** TURN *** [Ad 3d 3c][Jc]
Mecheblanche checks
titistrg bets 0.02€
Mecheblanche folds
titistrg collected 0.07€ from pot
*** SUMMARY ***
Total pot 0.07€ | No rake
Board: [Ad 3d 3c Jc]
Seat 2: titistrg won 0.07€


Winamax Poker - CashGame - HandId: #7336148-2534-1427480251 - Holdem no limit (0.01€/0.02€) - 2015/03/27 18:17:31 UTC
Table: 'Frankfurt 03' 9-max (real money) Seat #8 is the button
Seat 1: fran cky (1.98€)
Seat 2: titistrg (2.02€)
Seat 3: Nightbreed (2€)
Seat 4: sabre_laser (1.97€)
Seat 5: WaldoGeraldo (2.01€)
Seat 6: kalinka59230 (1.90€)
Seat 7: rick91 (1.77€)
Seat 8: foalinaah (2€)
Seat 9: Mecheblanche (3.15€)
*** ANTE/BLINDS ***
Mecheblanche posts small blind 0.01€
fran cky posts big blind 0.02€
Dealt to sabre_laser [2s 2h]
*** PRE-FLOP *** 
titistrg folds
Nightbreed folds
sabre_laser calls 0.02€
WaldoGeraldo raises 0.08€ to 0.10€
kalinka59230 folds
rick91 folds
foalinaah folds
Mecheblanche folds
fran cky folds
sabre_laser calls 0.08€
*** FLOP *** [7s Td Qc]
sabre_laser checks
WaldoGeraldo bets 0.08€
sabre_laser folds
WaldoGeraldo collected 0.30€ from pot
*** SUMMARY ***
Total pot 0.30€ | Rake 0.01€
Board: [7s Td Qc]
Seat 5: WaldoGeraldo won 0.30€


Winamax Poker - CashGame - HandId: #7336148-2535-1427480305 - Holdem no limit (0.01€/0.02€) - 2015/03/27 18:18:25 UTC
Table: 'Frankfurt 03' 9-max (real money) Seat #9 is the button
Seat 1: fran cky (1.96€)
Seat 2: titistrg (2.02€)
Seat 3: Nightbreed (2€)
Seat 4: sabre_laser (1.87€)
Seat 5: WaldoGeraldo (2.13€)
Seat 6: kalinka59230 (1.90€)
Seat 7: rick91 (1.77€)
Seat 8: foalinaah (2€)
Seat 9: Mecheblanche (3.14€)
*** ANTE/BLINDS ***
fran cky posts small blind 0.01€
titistrg posts big blind 0.02€
Dealt to sabre_laser [8h Kh]
*** PRE-FLOP *** 
Nightbreed folds
sabre_laser raises 0.03€ to 0.05€
WaldoGeraldo folds
kalinka59230 calls 0.05€
rick91 folds
foalinaah folds
Mecheblanche folds
fran cky folds
titistrg calls 0.03€
*** FLOP *** [Ac Ah 2s]
titistrg checks
sabre_laser checks
kalinka59230 checks
*** TURN *** [Ac Ah 2s][Ad]
titistrg checks
sabre_laser checks
kalinka59230 checks
*** RIVER *** [Ac Ah 2s Ad][2c]
titistrg checks
sabre_laser checks
kalinka59230 checks
*** SHOW DOWN ***
titistrg shows [6s Js] (Full of Aces and 2)
sabre_laser shows [8h Kh] (Full of Aces and 2)
kalinka59230 shows [Jc Tc] (Full of Aces and 2)
kalinka59230 collected 0.05€ from pot
sabre_laser collected 0.05€ from pot
titistrg collected 0.05€ from pot
*** SUMMARY ***
Total pot 0.15€ | Rake 0.01€
Board: [Ac Ah 2s Ad 2c]
Seat 2: titistrg (big blind) showed [6s Js] and won 0.05€ with Full of Aces and 2
Seat 4: sabre_laser showed [8h Kh] and won 0.05€ with Full of Aces and 2
Seat 6: kalinka59230 showed [Jc Tc] and won 0.05€ with Full of Aces and 2


Winamax Poker - CashGame - HandId: #7336148-2536-1427480415 - Holdem no limit (0.01€/0.02€) - 2015/03/27 18:20:15 UTC
Table: 'Frankfurt 03' 9-max (real money) Seat #1 is the button
Seat 1: fran cky (1.95€)
Seat 2: titistrg (2.02€)
Seat 3: Nightbreed (2€)
Seat 4: sabre_laser (1.87€)
Seat 5: WaldoGeraldo (2.13€)
Seat 6: kalinka59230 (1.90€)
Seat 7: rick91 (1.77€)
Seat 8: foalinaah (2€)
Seat 9: Mecheblanche (3.14€)
*** ANTE/BLINDS ***
titistrg posts small blind 0.01€
Nightbreed posts big blind 0.02€
Dealt to sabre_laser [3s 7d]
*** PRE-FLOP *** 
sabre_laser folds
WaldoGeraldo folds
kalinka59230 folds
rick91 folds
foalinaah folds
Mecheblanche folds
fran cky folds
titistrg calls 0.01€
Nightbreed checks
*** FLOP *** [Kh Kd Ad]
titistrg bets 0.04€
Nightbreed calls 0.04€
*** TURN *** [Kh Kd Ad][9d]
titistrg bets 0.12€
Nightbreed folds
titistrg collected 0.23€ from pot
*** SUMMARY ***
Total pot 0.23€ | Rake 0.01€
Board: [Kh Kd Ad 9d]
Seat 2: titistrg (small blind) won 0.23€


Winamax Poker - CashGame - HandId: #7336148-2537-1427480470 - Holdem no limit (0.01€/0.02€) - 2015/03/27 18:21:10 UTC
Table: 'Frankfurt 03' 9-max (real money) Seat #2 is the button
Seat 1: fran cky (1.95€)
Seat 2: titistrg (2.07€)
Seat 3: Nightbreed (2€)
Seat 4: sabre_laser (1.87€)
Seat 5: WaldoGeraldo (2.13€)
Seat 6: kalinka59230 (1.90€)
Seat 7: rick91 (1.77€)
Seat 8: foalinaah (2€)
Seat 9: Mecheblanche (3.14€)
*** ANTE/BLINDS ***
Nightbreed posts small blind 0.01€
sabre_laser posts big blind 0.02€
Dealt to sabre_laser [Ts 9d]
*** PRE-FLOP *** 
WaldoGeraldo folds
kalinka59230 folds
rick91 folds
foalinaah folds
Mecheblanche folds
fran cky folds
titistrg folds
Nightbreed raises 0.04€ to 0.06€
sabre_laser calls 0.04€
*** FLOP *** [7s 3d Ks]
Nightbreed bets 0.06€
sabre_laser folds
Nightbreed collected 0.17€ from pot
*** SUMMARY ***
Total pot 0.17€ | Rake 0.01€
Board: [7s 3d Ks]
Seat 3: Nightbreed (small blind) won 0.17€


Winamax Poker - CashGame - HandId: #7336148-2538-1427480520 - Holdem no limit (0.01€/0.02€) - 2015/03/27 18:22:00 UTC
Table: 'Frankfurt 03' 9-max (real money) Seat #3 is the button
Seat 1: fran cky (1.95€)
Seat 2: titistrg (2.07€)
Seat 3: Nightbreed (2.05€)
Seat 4: sabre_laser (1.81€)
Seat 5: WaldoGeraldo (2.13€)
Seat 6: kalinka59230 (1.90€)
Seat 7: rick91 (1.77€)
Seat 8: foalinaah (2€)
Seat 9: Mecheblanche (3.14€)
*** ANTE/BLINDS ***
sabre_laser posts small blind 0.01€
WaldoGeraldo posts big blind 0.02€
Dealt to sabre_laser [Ah Kc]
*** PRE-FLOP *** 
kalinka59230 folds
rick91 calls 0.02€
foalinaah folds
Mecheblanche folds
fran cky folds
titistrg folds
Nightbreed calls 0.02€
sabre_laser raises 0.08€ to 0.10€
WaldoGeraldo folds
rick91 folds
Nightbreed folds
sabre_laser collected 0.16€ from pot
*** SUMMARY ***
Total pot 0.16€ | No rake
Seat 4: sabre_laser (small blind) won 0.16€


Winamax Poker - CashGame - HandId: #7336148-2539-1427480601 - Holdem no limit (0.01€/0.02€) - 2015/03/27 18:23:21 UTC
Table: 'Frankfurt 03' 9-max (real money) Seat #4 is the button
Seat 1: fran cky (1.95€)
Seat 2: titistrg (2.07€)
Seat 3: Nightbreed (2.03€)
Seat 4: sabre_laser (1.87€)
Seat 5: WaldoGeraldo (2.11€)
Seat 6: kalinka59230 (1.90€)
Seat 7: rick91 (1.75€)
Seat 8: foalinaah (2€)
Seat 9: Mecheblanche (3.14€)
*** ANTE/BLINDS ***
WaldoGeraldo posts small blind 0.01€
kalinka59230 posts big blind 0.02€
Dealt to sabre_laser [8d 3s]
*** PRE-FLOP *** 
rick91 calls 0.02€
foalinaah folds
Mecheblanche folds
fran cky folds
titistrg calls 0.02€
Nightbreed folds
sabre_laser folds
WaldoGeraldo folds
kalinka59230 checks
*** FLOP *** [7c 6d Th]
kalinka59230 checks
rick91 checks
titistrg checks
*** TURN *** [7c 6d Th][5s]
kalinka59230 checks
rick91 checks
titistrg checks
*** RIVER *** [7c 6d Th 5s][5d]
kalinka59230 checks
rick91 checks
titistrg checks
*** SHOW DOWN ***
kalinka59230 shows [2h Jh] (One pair : 5)
rick91 shows [Kd Jd] (One pair : 5)
titistrg shows [Kh Qs] (One pair : 5)
titistrg collected 0.07€ from pot
*** SUMMARY ***
Total pot 0.07€ | No rake
Board: [7c 6d Th 5s 5d]
Seat 2: titistrg showed [Kh Qs] and won 0.07€ with One pair : 5
Seat 6: kalinka59230 (big blind) showed [2h Jh] and lost with One pair : 5
Seat 7: rick91 showed [Kd Jd] and lost with One pair : 5


Winamax Poker - CashGame - HandId: #7336148-2540-1427480685 - Holdem no limit (0.01€/0.02€) - 2015/03/27 18:24:45 UTC
Table: 'Frankfurt 03' 9-max (real money) Seat #5 is the button
Seat 1: fran cky (1.95€)
Seat 2: titistrg (2.12€)
Seat 3: Nightbreed (2.03€)
Seat 4: sabre_laser (1.87€)
Seat 5: WaldoGeraldo (2.10€)
Seat 6: kalinka59230 (1.88€)
Seat 7: rick91 (1.73€)
Seat 8: foalinaah (2€)
Seat 9: Mecheblanche (3.14€)
*** ANTE/BLINDS ***
kalinka59230 posts small blind 0.01€
rick91 posts big blind 0.02€
Dealt to sabre_laser [7h 8d]
*** PRE-FLOP *** 
foalinaah folds
Mecheblanche calls 0.02€
fran cky calls 0.02€
titistrg calls 0.02€
Nightbreed folds
sabre_laser folds
WaldoGeraldo folds
kalinka59230 folds
rick91 checks
*** FLOP *** [9d 9s 6d]
rick91 checks
Mecheblanche checks
fran cky checks
titistrg checks
*** TURN *** [9d 9s 6d][6s]
rick91 checks
Mecheblanche checks
fran cky checks
titistrg checks
*** RIVER *** [9d 9s 6d 6s][As]
rick91 checks
Mecheblanche checks
fran cky checks
titistrg checks
*** SHOW DOWN ***
titistrg shows [2d Kd] (Two pairs : 9 and 6)
rick91 shows [2h 3h] (Two pairs : 9 and 6)
Mecheblanche shows [5h 5s] (Two pairs : 9 and 6)
fran cky shows [Ad Jd] (Two pairs : Aces and 9)
fran cky collected 0.08€ from pot
*** SUMMARY ***
Total pot 0.08€ | Rake 0.01€
Board: [9d 9s 6d 6s As]
Seat 1: fran cky showed [Ad Jd] and won 0.08€ with Two pairs : Aces and 9
Seat 2: titistrg showed [2d Kd] and lost with Two pairs : 9 and 6
Seat 7: rick91 (big blind) showed [2h 3h] and lost with Two pairs : 9 and 6
Seat 9: Mecheblanche showed [5h 5s] and lost with Two pairs : 9 and 6


Winamax Poker - CashGame - HandId: #7336148-2541-1427480784 - Holdem no limit (0.01€/0.02€) - 2015/03/27 18:26:24 UTC
Table: 'Frankfurt 03' 9-max (real money) Seat #6 is the button
Seat 1: fran cky (2.01€)
Seat 2: titistrg (2.10€)
Seat 3: Nightbreed (2.03€)
Seat 4: sabre_laser (1.87€)
Seat 5: WaldoGeraldo (2.10€)
Seat 6: kalinka59230 (1.87€)
Seat 7: rick91 (1.71€)
Seat 8: foalinaah (2€)
Seat 9: Mecheblanche (3.12€)
*** ANTE/BLINDS ***
foalinaah denies big blind
rick91 posts small blind 0.01€
Mecheblanche posts big blind 0.02€
Dealt to sabre_laser [2d Ah]
*** PRE-FLOP *** 
fran cky folds
titistrg folds
Nightbreed folds
sabre_laser raises 0.03€ to 0.05€
WaldoGeraldo folds
kalinka59230 folds
rick91 folds
Mecheblanche calls 0.03€
*** FLOP *** [8d 4c Kc]
Mecheblanche bets 0.07€
sabre_laser folds
Mecheblanche collected 0.17€ from pot
*** SUMMARY ***
Total pot 0.17€ | Rake 0.01€
Board: [8d 4c Kc]
Seat 9: Mecheblanche (big blind) won 0.17€


Winamax Poker - CashGame - HandId: #7336148-2542-1427480825 - Holdem no limit (0.01€/0.02€) - 2015/03/27 18:27:05 UTC
Table: 'Frankfurt 03' 9-max (real money) Seat #7 is the button
Seat 1: fran cky (2.01€)
Seat 2: titistrg (2.10€)
Seat 3: Nightbreed (2.03€)
Seat 4: sabre_laser (1.82€)
Seat 5: WaldoGeraldo (2.10€)
Seat 6: kalinka59230 (1.87€)
Seat 7: rick91 (1.70€)
Seat 8: foalinaah (2€)
Seat 9: Mecheblanche (3.17€)
*** ANTE/BLINDS ***
Mecheblanche posts small blind 0.01€
fran cky posts big blind 0.02€
Dealt to sabre_laser [4d 5c]
*** PRE-FLOP *** 
titistrg folds
Nightbreed folds
sabre_laser folds
WaldoGeraldo folds
kalinka59230 folds
rick91 folds
Mecheblanche folds
fran cky collected 0.03€ from pot
*** SUMMARY ***
Total pot 0.03€ | No rake
Seat 1: fran cky (big blind) won 0.03€


Winamax Poker - CashGame - HandId: #7336148-2543-1427480905 - Holdem no limit (0.01€/0.02€) - 2015/03/27 18:28:25 UTC
Table: 'Frankfurt 03' 9-max (real money) Seat #9 is the button
Seat 1: fran cky (2.02€)
Seat 2: Wondu59 (2€)
Seat 3: Nightbreed (2.03€)
Seat 4: sabre_laser (1.82€)
Seat 5: WaldoGeraldo (2.10€)
Seat 6: kalinka59230 (1.87€)
Seat 7: rick91 (1.70€)
Seat 8: foalinaah (2€)
Seat 9: Mecheblanche (3.16€)
*** ANTE/BLINDS ***
fran cky posts small blind 0.01€
Wondu59 posts big blind 0.02€
Dealt to sabre_laser [Td 5c]
*** PRE-FLOP *** 
Nightbreed folds
sabre_laser folds
WaldoGeraldo folds
kalinka59230 folds
rick91 folds
Mecheblanche raises 0.04€ to 0.06€
fran cky folds
Wondu59 folds
Mecheblanche collected 0.09€ from pot
*** SUMMARY ***
Total pot 0.09€ | No rake
Seat 9: Mecheblanche (button) won 0.09€


Winamax Poker - CashGame - HandId: #7336148-2544-1427480943 - Holdem no limit (0.01€/0.02€) - 2015/03/27 18:29:03 UTC
Table: 'Frankfurt 03' 9-max (real money) Seat #1 is the button
Seat 1: fran cky (2.01€)
Seat 2: Wondu59 (2€)
Seat 3: Nightbreed (2.03€)
Seat 4: sabre_laser (1.82€)
Seat 5: WaldoGeraldo (2.10€)
Seat 6: kalinka59230 (1.87€)
Seat 7: rick91 (1.70€)
Seat 8: foalinaah (2€)
Seat 9: Mecheblanche (3.19€)
*** ANTE/BLINDS ***
Wondu59 posts small blind 0.01€
Nightbreed posts big blind 0.02€
Dealt to sabre_laser [7s 6c]
*** PRE-FLOP *** 
sabre_laser folds
WaldoGeraldo folds
kalinka59230 raises 0.04€ to 0.06€
rick91 folds
Mecheblanche folds
fran cky folds
Wondu59 folds
Nightbreed folds
kalinka59230 collected 0.09€ from pot
*** SUMMARY ***
Total pot 0.09€ | No rake
Seat 6: kalinka59230 won 0.09€


Winamax Poker - CashGame - HandId: #7336148-2545-1427480984 - Holdem no limit (0.01€/0.02€) - 2015/03/27 18:29:44 UTC
Table: 'Frankfurt 03' 9-max (real money) Seat #2 is the button
Seat 1: fran cky (2.01€)
Seat 2: Wondu59 (2€)
Seat 3: Nightbreed (2.01€)
Seat 4: sabre_laser (1.82€)
Seat 5: WaldoGeraldo (2.10€)
Seat 6: kalinka59230 (1.90€)
Seat 7: rick91 (1.70€)
Seat 8: foalinaah (2€)
Seat 9: Mecheblanche (3.19€)
*** ANTE/BLINDS ***
Nightbreed posts small blind 0.01€
sabre_laser posts big blind 0.02€
Dealt to sabre_laser [Qd 2s]
*** PRE-FLOP *** 
WaldoGeraldo folds
kalinka59230 folds
rick91 folds
Mecheblanche folds
fran cky folds
Wondu59 folds
Nightbreed raises 0.04€ to 0.06€
sabre_laser folds
Nightbreed collected 0.08€ from pot
*** SUMMARY ***
Total pot 0.08€ | No rake
Seat 3: Nightbreed (small blind) won 0.08€


Winamax Poker - CashGame - HandId: #7336148-2546-1427481013 - Holdem no limit (0.01€/0.02€) - 2015/03/27 18:30:13 UTC
Table: 'Frankfurt 03' 9-max (real money) Seat #3 is the button
Seat 1: fran cky (2.01€)
Seat 2: Wondu59 (2€)
Seat 3: Nightbreed (2.03€)
Seat 4: sabre_laser (1.80€)
Seat 5: WaldoGeraldo (2.10€)
Seat 6: kalinka59230 (1.90€)
Seat 7: rick91 (1.70€)
Seat 8: foalinaah (2€)
Seat 9: Mecheblanche (3.19€)
*** ANTE/BLINDS ***
sabre_laser posts small blind 0.01€
WaldoGeraldo posts big blind 0.02€
Dealt to sabre_laser [As 3c]
*** PRE-FLOP *** 
kalinka59230 folds
rick91 folds
Mecheblanche raises 0.04€ to 0.06€
fran cky folds
Wondu59 calls 0.06€
Nightbreed folds
sabre_laser folds
WaldoGeraldo calls 0.04€
*** FLOP *** [Ks 9d 2c]
WaldoGeraldo checks
Mecheblanche checks
Wondu59 checks
*** TURN *** [Ks 9d 2c][Qh]
WaldoGeraldo checks
Mecheblanche checks
Wondu59 checks
*** RIVER *** [Ks 9d 2c Qh][Kh]
WaldoGeraldo checks
Mecheblanche checks
Wondu59 checks
*** SHOW DOWN ***
Wondu59 shows [7h 7d] (Two pairs : Kings and 7)
WaldoGeraldo shows [Jc Ac] (One pair : Kings)
Mecheblanche shows [Jh Jd] (Two pairs : Kings and Jacks)
Mecheblanche collected 0.18€ from pot
*** SUMMARY ***
Total pot 0.18€ | Rake 0.01€
Board: [Ks 9d 2c Qh Kh]
Seat 2: Wondu59 showed [7h 7d] and lost with Two pairs : Kings and 7
Seat 5: WaldoGeraldo (big blind) showed [Jc Ac] and lost with One pair : Kings
Seat 9: Mecheblanche showed [Jh Jd] and won 0.18€ with Two pairs : Kings and Jacks


Winamax Poker - CashGame - HandId: #7336148-2547-1427481113 - Holdem no limit (0.01€/0.02€) - 2015/03/27 18:31:53 UTC
Table: 'Frankfurt 03' 9-max (real money) Seat #4 is the button
Seat 1: fran cky (2.01€)
Seat 2: Wondu59 (2€)
Seat 3: Nightbreed (2.03€)
Seat 4: sabre_laser (1.79€)
Seat 5: WaldoGeraldo (2.04€)
Seat 6: kalinka59230 (1.90€)
Seat 7: rick91 (1.70€)
Seat 8: foalinaah (2€)
Seat 9: Mecheblanche (3.31€)
*** ANTE/BLINDS ***
WaldoGeraldo posts small blind 0.01€
kalinka59230 posts big blind 0.02€
Dealt to sabre_laser [3s 6h]
*** PRE-FLOP *** 
rick91 folds
Mecheblanche folds
fran cky folds
Wondu59 folds
Nightbreed folds
sabre_laser folds
WaldoGeraldo calls 0.01€
kalinka59230 checks
*** FLOP *** [Ad 4d 2h]
WaldoGeraldo bets 0.02€
kalinka59230 calls 0.02€
*** TURN *** [Ad 4d 2h][9c]
WaldoGeraldo bets 0.04€
kalinka59230 folds
WaldoGeraldo collected 0.11€ from pot
*** SUMMARY ***
Total pot 0.11€ | Rake 0.01€
Board: [Ad 4d 2h 9c]
Seat 5: WaldoGeraldo (small blind) won 0.11€


Winamax Poker - CashGame - HandId: #7336148-2548-1427481148 - Holdem no limit (0.01€/0.02€) - 2015/03/27 18:32:28 UTC
Table: 'Frankfurt 03' 9-max (real money) Seat #5 is the button
Seat 1: fran cky (2.01€)
Seat 2: Wondu59 (2€)
Seat 3: Nightbreed (2.03€)
Seat 4: sabre_laser (1.79€)
Seat 5: WaldoGeraldo (2.07€)
Seat 6: kalinka59230 (1.86€)
Seat 7: rick91 (1.70€)
Seat 8: foalinaah (2€)
Seat 9: Mecheblanche (3.31€)
*** ANTE/BLINDS ***
kalinka59230 posts small blind 0.01€
rick91 posts big blind 0.02€
Dealt to sabre_laser [2d Ac]
*** PRE-FLOP *** 
Mecheblanche raises 0.06€ to 0.08€
fran cky folds
Wondu59 folds
Nightbreed folds
sabre_laser folds
WaldoGeraldo folds
kalinka59230 folds
rick91 calls 0.06€
*** FLOP *** [3d Th 3h]
rick91 checks
Mecheblanche bets 0.09€
rick91 folds
Mecheblanche collected 0.25€ from pot
*** SUMMARY ***
Total pot 0.25€ | Rake 0.01€
Board: [3d Th 3h]
Seat 9: Mecheblanche won 0.25€


Winamax Poker - CashGame - HandId: #7336148-2549-1427481206 - Holdem no limit (0.01€/0.02€) - 2015/03/27 18:33:26 UTC
Table: 'Frankfurt 03' 9-max (real money) Seat #6 is the button
Seat 1: fran cky (2.01€)
Seat 2: Wondu59 (2€)
Seat 3: Nightbreed (2.03€)
Seat 4: sabre_laser (1.79€)
Seat 5: WaldoGeraldo (2.07€)
Seat 6: kalinka59230 (1.85€)
Seat 7: rick91 (1.62€)
Seat 8: foalinaah (2€)
Seat 9: Mecheblanche (3.39€)
*** ANTE/BLINDS ***
rick91 posts small blind 0.01€
foalinaah posts big blind 0.02€
Dealt to sabre_laser [As 3h]
*** PRE-FLOP *** 
Mecheblanche folds
fran cky folds
Wondu59 folds
Nightbreed folds
sabre_laser raises 0.05€ to 0.07€
WaldoGeraldo folds
kalinka59230 calls 0.07€
rick91 folds
foalinaah calls 0.05€
*** FLOP *** [8h 6h 3c]
foalinaah checks
sabre_laser bets 0.22€
kalinka59230 folds
foalinaah calls 0.22€
*** TURN *** [8h 6h 3c][Qs]
foalinaah checks
sabre_laser checks
*** RIVER *** [8h 6h 3c Qs][4d]
foalinaah checks
sabre_laser bets 0.44€
foalinaah folds
sabre_laser collected 1.06€ from pot
*** SUMMARY ***
Total pot 1.06€ | Rake 0.04€
Board: [8h 6h 3c Qs 4d]
Seat 4: sabre_laser won 1.06€


Winamax Poker - CashGame - HandId: #7336148-2550-1427481309 - Holdem no limit (0.01€/0.02€) - 2015/03/27 18:35:09 UTC
Table: 'Frankfurt 03' 9-max (real money) Seat #7 is the button
Seat 1: fran cky (2.01€)
Seat 2: Wondu59 (2€)
Seat 3: Nightbreed (2.03€)
Seat 4: sabre_laser (2.12€)
Seat 5: WaldoGeraldo (2.07€)
Seat 6: kalinka59230 (1.78€)
Seat 7: rick91 (1.61€)
Seat 8: foalinaah (2€)
Seat 9: Mecheblanche (3.39€)
*** ANTE/BLINDS ***
foalinaah posts small blind 0.01€
Mecheblanche posts big blind 0.02€
Dealt to sabre_laser [Ad 7c]
*** PRE-FLOP *** 
fran cky folds
Wondu59 folds
Nightbreed folds
sabre_laser folds
WaldoGeraldo folds
kalinka59230 folds
rick91 folds
foalinaah folds
Mecheblanche collected 0.03€ from pot
*** SUMMARY ***
Total pot 0.03€ | No rake
Seat 9: Mecheblanche (big blind) won 0.03€


Winamax Poker - CashGame - HandId: #7336148-2551-1427481342 - Holdem no limit (0.01€/0.02€) - 2015/03/27 18:35:42 UTC
Table: 'Frankfurt 03' 9-max (real money) Seat #8 is the button
Seat 1: fran cky (2.01€)
Seat 2: Wondu59 (2€)
Seat 3: Nightbreed (2.03€)
Seat 4: sabre_laser (2.12€)
Seat 5: WaldoGeraldo (2.07€)
Seat 6: kalinka59230 (1.78€)
Seat 7: rick91 (1.61€)
Seat 8: foalinaah (2€)
Seat 9: Mecheblanche (3.40€)
*** ANTE/BLINDS ***
Mecheblanche posts small blind 0.01€
fran cky posts big blind 0.02€
Dealt to sabre_laser [Qh Ah]
*** PRE-FLOP *** 
Wondu59 folds
Nightbreed folds
sabre_laser raises 0.05€ to 0.07€
WaldoGeraldo folds
kalinka59230 folds
rick91 folds
foalinaah folds
Mecheblanche folds
fran cky calls 0.05€
*** FLOP *** [2c 3s 7s]
fran cky checks
sabre_laser bets 0.15€
fran cky folds
sabre_laser collected 0.29€ from pot
*** SUMMARY ***
Total pot 0.29€ | Rake 0.01€
Board: [2c 3s 7s]
Seat 4: sabre_laser won 0.29€


Winamax Poker - CashGame - HandId: #7336148-2552-1427481398 - Holdem no limit (0.01€/0.02€) - 2015/03/27 18:36:38 UTC
Table: 'Frankfurt 03' 9-max (real money) Seat #9 is the button
Seat 1: fran cky (2€)
Seat 2: Wondu59 (2€)
Seat 3: Nightbreed (2.03€)
Seat 4: sabre_laser (2.19€)
Seat 5: WaldoGeraldo (2.07€)
Seat 6: kalinka59230 (1.78€)
Seat 7: rick91 (1.61€)
Seat 8: foalinaah (2€)
Seat 9: Mecheblanche (3.39€)
*** ANTE/BLINDS ***
fran cky posts small blind 0.01€
Wondu59 posts big blind 0.02€
Dealt to sabre_laser [Qs 7s]
*** PRE-FLOP *** 
Nightbreed folds
sabre_laser folds
WaldoGeraldo folds
kalinka59230 folds
rick91 folds
foalinaah raises 0.06€ to 0.08€
Mecheblanche folds
fran cky folds
Wondu59 folds
foalinaah collected 0.11€ from pot
*** SUMMARY ***
Total pot 0.11€ | No rake
Seat 8: foalinaah won 0.11€


Winamax Poker - CashGame - HandId: #7336148-2553-1427481451 - Holdem no limit (0.01€/0.02€) - 2015/03/27 18:37:31 UTC
Table: 'Frankfurt 03' 9-max (real money) Seat #1 is the button
Seat 1: fran cky (2€)
Seat 2: Wondu59 (2€)
Seat 3: Nightbreed (2.03€)
Seat 4: sabre_laser (2.19€)
Seat 5: WaldoGeraldo (2.07€)
Seat 6: kalinka59230 (1.78€)
Seat 7: rick91 (1.61€)
Seat 8: foalinaah (2.03€)
Seat 9: Mecheblanche (3.39€)
*** ANTE/BLINDS ***
Wondu59 posts small blind 0.01€
Nightbreed posts big blind 0.02€
Dealt to sabre_laser [9c Jd]
*** PRE-FLOP *** 
sabre_laser folds
WaldoGeraldo raises 0.06€ to 0.08€
kalinka59230 folds
rick91 folds
foalinaah folds
Mecheblanche folds
fran cky folds
Wondu59 folds
Nightbreed folds
WaldoGeraldo collected 0.11€ from pot
*** SUMMARY ***
Total pot 0.11€ | No rake
Seat 5: WaldoGeraldo won 0.11€


Winamax Poker - CashGame - HandId: #7336148-2554-1427481499 - Holdem no limit (0.01€/0.02€) - 2015/03/27 18:38:19 UTC
Table: 'Frankfurt 03' 9-max (real money) Seat #2 is the button
Seat 1: fran cky (2€)
Seat 2: Wondu59 (2€)
Seat 3: Nightbreed (2.01€)
Seat 4: sabre_laser (2.19€)
Seat 5: WaldoGeraldo (2.10€)
Seat 6: kalinka59230 (1.78€)
Seat 7: rick91 (1.61€)
Seat 8: foalinaah (2.03€)
Seat 9: Mecheblanche (3.39€)
*** ANTE/BLINDS ***
Nightbreed posts small blind 0.01€
sabre_laser posts big blind 0.02€
Dealt to sabre_laser [6d Jc]
*** PRE-FLOP *** 
WaldoGeraldo folds
kalinka59230 folds
rick91 folds
foalinaah folds
Mecheblanche folds
fran cky folds
Wondu59 raises 0.03€ to 0.05€
Nightbreed folds
sabre_laser calls 0.03€
*** FLOP *** [9h 7c 4c]
sabre_laser checks
Wondu59 bets 0.07€
sabre_laser folds
Wondu59 collected 0.17€ from pot
*** SUMMARY ***
Total pot 0.17€ | Rake 0.01€
Board: [9h 7c 4c]
Seat 2: Wondu59 (button) won 0.17€


Winamax Poker - CashGame - HandId: #7336148-2555-1427481565 - Holdem no limit (0.01€/0.02€) - 2015/03/27 18:39:25 UTC
Table: 'Frankfurt 03' 9-max (real money) Seat #3 is the button
Seat 1: fran cky (2€)
Seat 2: Wondu59 (2.05€)
Seat 3: Nightbreed (2€)
Seat 4: sabre_laser (2.14€)
Seat 5: WaldoGeraldo (2.10€)
Seat 6: kalinka59230 (1.78€)
Seat 7: rick91 (1.61€)
Seat 8: foalinaah (2.03€)
Seat 9: Mecheblanche (3.39€)
*** ANTE/BLINDS ***
sabre_laser posts small blind 0.01€
WaldoGeraldo posts big blind 0.02€
Dealt to sabre_laser [7s Tc]
*** PRE-FLOP *** 
kalinka59230 folds
rick91 calls 0.02€
foalinaah folds
Mecheblanche calls 0.02€
fran cky folds
Wondu59 folds
Nightbreed folds
sabre_laser calls 0.01€
WaldoGeraldo checks
*** FLOP *** [5h Jd 5s]
sabre_laser checks
WaldoGeraldo bets 0.06€
rick91 folds
Mecheblanche folds
sabre_laser folds
WaldoGeraldo collected 0.13€ from pot
*** SUMMARY ***
Total pot 0.13€ | Rake 0.01€
Board: [5h Jd 5s]
Seat 5: WaldoGeraldo (big blind) won 0.13€


