Winamax Poker - Tournament "KING 5 - Stade 1C" buyIn: Ticket only level: 0 - HandId: #469971603749339142-1-1424805025 - Holdem no limit (10/20) - 2015/02/24 19:10:25 UTC
Table: 'KING 5 - Stade 1C(109423791)#005' 9-max (real money) Seat #4 is the button
Seat 1: rodgerstaps (4000)
Seat 2: sebishere (4000)
Seat 3: Belle&Sainte (4000)
Seat 4: sabre_laser (4000)
Seat 5: o0oClAiReoOo (4000)
Seat 6: Lulue87 (4000)
Seat 7: Kephren25 (4000)
Seat 8: 34schiele (4000)
Seat 9: Chewie12 (4000)
*** ANTE/BLINDS ***
o0oClAiReoOo posts small blind 10
Lulue87 posts big blind 20
Dealt to sabre_laser [Kc Ac]
*** PRE-FLOP *** 
Kephren25 folds
34schiele folds
Chewie12 folds
rodgerstaps folds
sebishere folds
Belle&Sainte folds
sabre_laser raises 30 to 50
o0oClAiReoOo calls 40
Lulue87 folds
*** FLOP *** [Qh 3c Qs]
o0oClAiReoOo checks
sabre_laser bets 50
o0oClAiReoOo calls 50
*** TURN *** [Qh 3c Qs][Js]
o0oClAiReoOo checks
sabre_laser checks
*** RIVER *** [Qh 3c Qs Js][Jh]
o0oClAiReoOo checks
sabre_laser checks
*** SHOW DOWN ***
o0oClAiReoOo shows [6c 6s] (Two pairs : Queens and Jacks)
sabre_laser shows [Kc Ac] (Two pairs : Queens and Jacks)
sabre_laser collected 220 from pot
*** SUMMARY ***
Total pot 220 | No rake
Board: [Qh 3c Qs Js Jh]
Seat 4: sabre_laser (button) showed [Kc Ac] and won 220 with Two pairs : Queens and Jacks
Seat 5: o0oClAiReoOo (small blind) showed [6c 6s] and lost with Two pairs : Queens and Jacks


Winamax Poker - Tournament "KING 5 - Stade 1C" buyIn: Ticket only level: 0 - HandId: #469971603749339142-2-1424805097 - Holdem no limit (10/20) - 2015/02/24 19:11:37 UTC
Table: 'KING 5 - Stade 1C(109423791)#005' 9-max (real money) Seat #5 is the button
Seat 1: rodgerstaps (4000)
Seat 2: sebishere (4000)
Seat 3: Belle&Sainte (4000)
Seat 4: sabre_laser (4120)
Seat 5: o0oClAiReoOo (3900)
Seat 6: Lulue87 (3980)
Seat 7: Kephren25 (4000)
Seat 8: 34schiele (4000)
Seat 9: Victoria8888 (3990)
*** ANTE/BLINDS ***
Lulue87 posts small blind 10
Kephren25 posts big blind 20
Dealt to sabre_laser [Td 3h]
*** PRE-FLOP *** 
34schiele folds
Victoria8888 raises 40 to 60
rodgerstaps folds
sebishere folds
Belle&Sainte folds
sabre_laser folds
o0oClAiReoOo folds
Lulue87 folds
Kephren25 calls 40
*** FLOP *** [Kd 9d 2h]
Kephren25 checks
Victoria8888 bets 65
Kephren25 folds
Victoria8888 collected 195 from pot
*** SUMMARY ***
Total pot 195 | No rake
Board: [Kd 9d 2h]
Seat 9: Victoria8888 won 195


Winamax Poker - Tournament "KING 5 - Stade 1C" buyIn: Ticket only level: 0 - HandId: #469971603749339142-3-1424805128 - Holdem no limit (10/20) - 2015/02/24 19:12:08 UTC
Table: 'KING 5 - Stade 1C(109423791)#005' 9-max (real money) Seat #6 is the button
Seat 1: rodgerstaps (4000)
Seat 2: sebishere (4000)
Seat 3: Belle&Sainte (4000)
Seat 4: sabre_laser (4120)
Seat 5: o0oClAiReoOo (3900)
Seat 6: Lulue87 (3970)
Seat 7: Kephren25 (3940)
Seat 8: la trompette (4000)
Seat 9: Victoria8888 (4060)
*** ANTE/BLINDS ***
Kephren25 posts small blind 10
la trompette posts big blind 20
Dealt to sabre_laser [7h Td]
*** PRE-FLOP *** 
Victoria8888 folds
rodgerstaps folds
sebishere folds
Belle&Sainte folds
sabre_laser folds
o0oClAiReoOo folds
Lulue87 calls 20
Kephren25 calls 10
la trompette raises 70 to 90
Lulue87 calls 70
Kephren25 folds
*** FLOP *** [9c 4s 4d]
la trompette bets 100
Lulue87 folds
la trompette collected 300 from pot
*** SUMMARY ***
Total pot 300 | No rake
Board: [9c 4s 4d]
Seat 8: la trompette (big blind) won 300


Winamax Poker - Tournament "KING 5 - Stade 1C" buyIn: Ticket only level: 0 - HandId: #469971603749339142-4-1424805207 - Holdem no limit (10/20) - 2015/02/24 19:13:27 UTC
Table: 'KING 5 - Stade 1C(109423791)#005' 9-max (real money) Seat #7 is the button
Seat 1: rodgerstaps (4000)
Seat 2: sebishere (4000)
Seat 3: Belle&Sainte (4000)
Seat 4: sabre_laser (4120)
Seat 5: o0oClAiReoOo (3900)
Seat 6: Lulue87 (3880)
Seat 7: Kephren25 (3920)
Seat 8: la trompette (4110)
Seat 9: Victoria8888 (4060)
*** ANTE/BLINDS ***
la trompette posts small blind 10
Victoria8888 posts big blind 20
Dealt to sabre_laser [Kc Tc]
*** PRE-FLOP *** 
rodgerstaps folds
sebishere folds
Belle&Sainte folds
sabre_laser raises 50 to 70
o0oClAiReoOo folds
Lulue87 folds
Kephren25 calls 70
la trompette folds
Victoria8888 folds
*** FLOP *** [4d 8h Ac]
sabre_laser checks
Kephren25 checks
*** TURN *** [4d 8h Ac][9s]
sabre_laser bets 85
Kephren25 folds
sabre_laser collected 255 from pot
*** SUMMARY ***
Total pot 255 | No rake
Board: [4d 8h Ac 9s]
Seat 4: sabre_laser won 255


Winamax Poker - Tournament "KING 5 - Stade 1C" buyIn: Ticket only level: 0 - HandId: #469971603749339142-5-1424805307 - Holdem no limit (10/20) - 2015/02/24 19:15:07 UTC
Table: 'KING 5 - Stade 1C(109423791)#005' 9-max (real money) Seat #8 is the button
Seat 1: rodgerstaps (4000)
Seat 2: sebishere (4000)
Seat 3: Belle&Sainte (4000)
Seat 4: sabre_laser (4220)
Seat 5: o0oClAiReoOo (3900)
Seat 6: Lulue87 (3880)
Seat 7: Kephren25 (3850)
Seat 8: la trompette (4100)
Seat 9: Victoria8888 (4040)
*** ANTE/BLINDS ***
Victoria8888 posts small blind 10
rodgerstaps posts big blind 20
Dealt to sabre_laser [2h 3h]
*** PRE-FLOP *** 
sebishere raises 20 to 40
Belle&Sainte folds
sabre_laser folds
o0oClAiReoOo calls 40
Lulue87 folds
Kephren25 folds
la trompette folds
Victoria8888 folds
rodgerstaps folds
*** FLOP *** [2d Kc Ad]
sebishere checks
o0oClAiReoOo bets 55
sebishere folds
o0oClAiReoOo collected 165 from pot
*** SUMMARY ***
Total pot 165 | No rake
Board: [2d Kc Ad]
Seat 5: o0oClAiReoOo won 165


Winamax Poker - Tournament "KING 5 - Stade 1C" buyIn: Ticket only level: 0 - HandId: #469971603749339142-6-1424805395 - Holdem no limit (10/20) - 2015/02/24 19:16:35 UTC
Table: 'KING 5 - Stade 1C(109423791)#005' 9-max (real money) Seat #9 is the button
Seat 1: rodgerstaps (3980)
Seat 2: sebishere (3960)
Seat 3: Belle&Sainte (4000)
Seat 4: sabre_laser (4220)
Seat 5: o0oClAiReoOo (3970)
Seat 6: Lulue87 (3880)
Seat 7: Kephren25 (3850)
Seat 8: la trompette (4100)
Seat 9: Victoria8888 (4030)
*** ANTE/BLINDS ***
rodgerstaps posts small blind 10
sebishere posts big blind 20
Dealt to sabre_laser [Qd 4s]
*** PRE-FLOP *** 
Belle&Sainte folds
sabre_laser folds
o0oClAiReoOo calls 20
Lulue87 folds
Kephren25 folds
la trompette folds
Victoria8888 folds
rodgerstaps folds
sebishere checks
*** FLOP *** [8h 2h As]
sebishere checks
o0oClAiReoOo bets 40
sebishere calls 40
*** TURN *** [8h 2h As][6d]
sebishere checks
o0oClAiReoOo checks
*** RIVER *** [8h 2h As 6d][9d]
sebishere bets 40
o0oClAiReoOo calls 40
*** SHOW DOWN ***
o0oClAiReoOo shows [Qh 6h] (One pair : 6)
sebishere shows [Kh 8s] (One pair : 8)
sebishere collected 210 from pot
*** SUMMARY ***
Total pot 210 | No rake
Board: [8h 2h As 6d 9d]
Seat 2: sebishere (big blind) showed [Kh 8s] and won 210 with One pair : 8
Seat 5: o0oClAiReoOo showed [Qh 6h] and lost with One pair : 6


Winamax Poker - Tournament "KING 5 - Stade 1C" buyIn: Ticket only level: 0 - HandId: #469971603749339142-7-1424805478 - Holdem no limit (10/20) - 2015/02/24 19:17:58 UTC
Table: 'KING 5 - Stade 1C(109423791)#005' 9-max (real money) Seat #1 is the button
Seat 1: rodgerstaps (3970)
Seat 2: sebishere (4070)
Seat 3: Belle&Sainte (4000)
Seat 4: sabre_laser (4220)
Seat 5: o0oClAiReoOo (3870)
Seat 6: Lulue87 (3880)
Seat 7: vince_B69 (9910)
Seat 8: la trompette (4100)
Seat 9: Victoria8888 (4030)
*** ANTE/BLINDS ***
sebishere posts small blind 10
Belle&Sainte posts big blind 20
Dealt to sabre_laser [Jc Kh]
*** PRE-FLOP *** 
sabre_laser folds
o0oClAiReoOo folds
Lulue87 calls 20
vince_B69 folds
la trompette folds
Victoria8888 folds
rodgerstaps folds
sebishere folds
Belle&Sainte checks
*** FLOP *** [6c 4s Qh]
Belle&Sainte checks
Lulue87 checks
*** TURN *** [6c 4s Qh][Tc]
Belle&Sainte checks
Lulue87 checks
*** RIVER *** [6c 4s Qh Tc][9c]
Belle&Sainte checks
Lulue87 bets 33
Belle&Sainte folds
Lulue87 collected 83 from pot
*** SUMMARY ***
Total pot 83 | No rake
Board: [6c 4s Qh Tc 9c]
Seat 6: Lulue87 won 83


Winamax Poker - Tournament "KING 5 - Stade 1C" buyIn: Ticket only level: 1 - HandId: #469971603749339142-8-1424805554 - Holdem no limit (15/30) - 2015/02/24 19:19:14 UTC
Table: 'KING 5 - Stade 1C(109423791)#005' 9-max (real money) Seat #2 is the button
Seat 1: rodgerstaps (3970)
Seat 2: sebishere (4060)
Seat 3: Belle&Sainte (3980)
Seat 4: sabre_laser (4220)
Seat 5: o0oClAiReoOo (3870)
Seat 6: Loche (4000)
Seat 7: vince_B69 (9910)
Seat 8: la trompette (4100)
Seat 9: Victoria8888 (4030)
*** ANTE/BLINDS ***
Belle&Sainte posts small blind 15
sabre_laser posts big blind 30
Dealt to sabre_laser [Th 6s]
*** PRE-FLOP *** 
o0oClAiReoOo folds
Loche folds
vince_B69 folds
la trompette folds
Victoria8888 folds
rodgerstaps folds
sebishere folds
Belle&Sainte raises 45 to 75
sabre_laser folds
Belle&Sainte collected 105 from pot
*** SUMMARY ***
Total pot 105 | No rake
Seat 3: Belle&Sainte (small blind) won 105


Winamax Poker - Tournament "KING 5 - Stade 1C" buyIn: Ticket only level: 1 - HandId: #469971603749339142-9-1424805608 - Holdem no limit (15/30) - 2015/02/24 19:20:08 UTC
Table: 'KING 5 - Stade 1C(109423791)#005' 9-max (real money) Seat #3 is the button
Seat 1: rodgerstaps (3970)
Seat 2: sebishere (4060)
Seat 3: Belle&Sainte (4010)
Seat 4: sabre_laser (4190)
Seat 5: GwendALLIN (3980)
Seat 6: Loche (4000)
Seat 7: vince_B69 (9910)
Seat 8: la trompette (4100)
Seat 9: Victoria8888 (4030)
*** ANTE/BLINDS ***
sabre_laser posts small blind 15
GwendALLIN posts big blind 30
Dealt to sabre_laser [7s Tc]
*** PRE-FLOP *** 
Loche folds
vince_B69 folds
la trompette folds
Victoria8888 folds
rodgerstaps folds
sebishere folds
Belle&Sainte folds
sabre_laser calls 15
GwendALLIN checks
*** FLOP *** [Qc 5d Js]
sabre_laser bets 30
GwendALLIN calls 30
*** TURN *** [Qc 5d Js][5c]
sabre_laser checks
GwendALLIN checks
*** RIVER *** [Qc 5d Js 5c][Ah]
sabre_laser checks
GwendALLIN bets 105
sabre_laser folds
GwendALLIN collected 225 from pot
*** SUMMARY ***
Total pot 225 | No rake
Board: [Qc 5d Js 5c Ah]
Seat 5: GwendALLIN (big blind) won 225


Winamax Poker - Tournament "KING 5 - Stade 1C" buyIn: Ticket only level: 1 - HandId: #469971603749339263-14-1424805740 - Holdem no limit (15/30) - 2015/02/24 19:22:20 UTC
Table: 'KING 5 - Stade 1C(109423791)#126' 9-max (real money) Seat #3 is the button
Seat 1: slidercc60 (4220)
Seat 2: Indasky (7995)
Seat 3: sabre_laser (4130)
Seat 4: catimini56 (5334)
Seat 5: Kephren25 (3850)
Seat 6: jackymichell (4000)
Seat 7: Criis89100 (3698)
Seat 8: _NyX_ (2561)
Seat 9: Girlypok59 (3970)
*** ANTE/BLINDS ***
catimini56 posts small blind 15
Kephren25 posts big blind 30
*** PRE-FLOP *** 
jackymichell folds
Criis89100 calls 30
_NyX_ calls 30
Girlypok59 folds
slidercc60 folds
Indasky folds
catimini56 folds
Kephren25 checks
*** FLOP *** [Ah 4h 5h]
Kephren25 checks
Criis89100 checks
_NyX_ checks
*** TURN *** [Ah 4h 5h][Qh]
Kephren25 checks
Criis89100 checks
_NyX_ checks
*** RIVER *** [Ah 4h 5h Qh][8d]
Kephren25 checks
Criis89100 checks
_NyX_ checks
*** SHOW DOWN ***
Kephren25 shows [7d 9c] (High card : Ace)
_NyX_ shows [9s Ts] (High card : Ace)
Criis89100 shows [6d 5d] (One pair : 5)
Criis89100 collected 105 from pot
*** SUMMARY ***
Total pot 105 | No rake
Board: [Ah 4h 5h Qh 8d]
Seat 5: Kephren25 (big blind) showed [7d 9c] and lost with High card : Ace
Seat 7: Criis89100 showed [6d 5d] and won 105 with One pair : 5
Seat 8: _NyX_ showed [9s Ts] and lost with High card : Ace


Winamax Poker - Tournament "KING 5 - Stade 1C" buyIn: Ticket only level: 1 - HandId: #469971603749339263-15-1424805802 - Holdem no limit (15/30) - 2015/02/24 19:23:22 UTC
Table: 'KING 5 - Stade 1C(109423791)#126' 9-max (real money) Seat #4 is the button
Seat 1: slidercc60 (4220)
Seat 2: Indasky (7995)
Seat 3: sabre_laser (4130)
Seat 4: catimini56 (5319)
Seat 5: Kephren25 (3820)
Seat 6: jackymichell (4000)
Seat 7: Criis89100 (3773)
Seat 8: _NyX_ (2531)
Seat 9: Girlypok59 (3970)
*** ANTE/BLINDS ***
Kephren25 posts small blind 15
jackymichell posts big blind 30
Dealt to sabre_laser [Jc 2h]
*** PRE-FLOP *** 
Criis89100 calls 30
_NyX_ folds
Girlypok59 folds
slidercc60 folds
Indasky raises 75 to 105
sabre_laser folds
catimini56 folds
Kephren25 folds
jackymichell folds
Criis89100 calls 75
*** FLOP *** [2d Tc Ad]
Criis89100 checks
Indasky bets 128
Criis89100 folds
Indasky collected 383 from pot
*** SUMMARY ***
Total pot 383 | No rake
Board: [2d Tc Ad]
Seat 2: Indasky won 383


Winamax Poker - Tournament "KING 5 - Stade 1C" buyIn: Ticket only level: 1 - HandId: #469971603749339263-16-1424805862 - Holdem no limit (15/30) - 2015/02/24 19:24:22 UTC
Table: 'KING 5 - Stade 1C(109423791)#126' 9-max (real money) Seat #5 is the button
Seat 1: slidercc60 (4220)
Seat 2: Indasky (8145)
Seat 3: sabre_laser (4130)
Seat 4: catimini56 (5319)
Seat 5: Kephren25 (3805)
Seat 6: jackymichell (3970)
Seat 7: Criis89100 (3668)
Seat 8: _NyX_ (2531)
Seat 9: Girlypok59 (3970)
*** ANTE/BLINDS ***
jackymichell posts small blind 15
Criis89100 posts big blind 30
Dealt to sabre_laser [Ts Tc]
*** PRE-FLOP *** 
_NyX_ folds
Girlypok59 folds
slidercc60 folds
Indasky folds
sabre_laser raises 45 to 75
catimini56 folds
Kephren25 folds
jackymichell folds
Criis89100 calls 45
*** FLOP *** [Jd Kd 4c]
Criis89100 checks
sabre_laser bets 83
Criis89100 folds
sabre_laser collected 248 from pot
*** SUMMARY ***
Total pot 248 | No rake
Board: [Jd Kd 4c]
Seat 3: sabre_laser won 248


Winamax Poker - Tournament "KING 5 - Stade 1C" buyIn: Ticket only level: 1 - HandId: #469971603749339263-17-1424805937 - Holdem no limit (15/30) - 2015/02/24 19:25:37 UTC
Table: 'KING 5 - Stade 1C(109423791)#126' 9-max (real money) Seat #6 is the button
Seat 1: slidercc60 (4220)
Seat 2: AxelFooley (6866)
Seat 3: sabre_laser (4220)
Seat 4: catimini56 (5319)
Seat 5: Kephren25 (3805)
Seat 6: jackymichell (3955)
Seat 7: Criis89100 (3593)
Seat 8: _NyX_ (2531)
Seat 9: Girlypok59 (3970)
*** ANTE/BLINDS ***
Criis89100 posts small blind 15
_NyX_ posts big blind 30
Dealt to sabre_laser [Ah Th]
*** PRE-FLOP *** 
Girlypok59 folds
slidercc60 calls 30
AxelFooley folds
sabre_laser raises 75 to 105
catimini56 folds
Kephren25 folds
jackymichell folds
Criis89100 calls 90
_NyX_ folds
slidercc60 calls 75
*** FLOP *** [6d Kc 8c]
Criis89100 checks
slidercc60 bets 105
sabre_laser folds
Criis89100 raises 105 to 210
slidercc60 raises 105 to 315
Criis89100 calls 105
*** TURN *** [6d Kc 8c][Js]
Criis89100 checks
slidercc60 bets 105
Criis89100 calls 105
*** RIVER *** [6d Kc 8c Js][5c]
Criis89100 bets 593
slidercc60 calls 593
*** SHOW DOWN ***
slidercc60 shows [Ks Tc] (One pair : Kings)
Criis89100 shows [6s 6h] (Trips of 6)
Criis89100 collected 2371 from pot
*** SUMMARY ***
Total pot 2371 | No rake
Board: [6d Kc 8c Js 5c]
Seat 1: slidercc60 showed [Ks Tc] and lost with One pair : Kings
Seat 7: Criis89100 (small blind) showed [6s 6h] and won 2371 with Trips of 6


Winamax Poker - Tournament "KING 5 - Stade 1C" buyIn: Ticket only level: 2 - HandId: #469971603749339263-18-1424806017 - Holdem no limit (20/40) - 2015/02/24 19:26:57 UTC
Table: 'KING 5 - Stade 1C(109423791)#126' 9-max (real money) Seat #7 is the button
Seat 1: slidercc60 (3102)
Seat 2: AxelFooley (6866)
Seat 3: sabre_laser (4115)
Seat 4: catimini56 (5319)
Seat 5: Kephren25 (3805)
Seat 6: jackymichell (3955)
Seat 7: Criis89100 (4846)
Seat 8: _NyX_ (2501)
Seat 9: Girlypok59 (3970)
*** ANTE/BLINDS ***
_NyX_ posts small blind 20
Girlypok59 posts big blind 40
Dealt to sabre_laser [7d 5h]
*** PRE-FLOP *** 
slidercc60 folds
AxelFooley calls 40
sabre_laser folds
catimini56 folds
Kephren25 raises 60 to 100
jackymichell folds
Criis89100 raises 340 to 440
_NyX_ folds
Girlypok59 folds
AxelFooley folds
Kephren25 folds
Criis89100 collected 640 from pot
*** SUMMARY ***
Total pot 640 | No rake
Seat 7: Criis89100 (button) won 640


Winamax Poker - Tournament "KING 5 - Stade 1C" buyIn: Ticket only level: 2 - HandId: #469971603749339263-19-1424806077 - Holdem no limit (20/40) - 2015/02/24 19:27:57 UTC
Table: 'KING 5 - Stade 1C(109423791)#126' 9-max (real money) Seat #8 is the button
Seat 1: slidercc60 (3102)
Seat 2: AxelFooley (6826)
Seat 3: sabre_laser (4115)
Seat 4: catimini56 (5319)
Seat 5: Kephren25 (3705)
Seat 6: jackymichell (3955)
Seat 7: Criis89100 (5046)
Seat 8: _NyX_ (2481)
Seat 9: Girlypok59 (3930)
*** ANTE/BLINDS ***
Girlypok59 posts small blind 20
slidercc60 posts big blind 40
Dealt to sabre_laser [7s 9d]
*** PRE-FLOP *** 
AxelFooley folds
sabre_laser folds
catimini56 folds
Kephren25 raises 100 to 140
jackymichell folds
Criis89100 folds
_NyX_ folds
Girlypok59 folds
slidercc60 folds
Kephren25 collected 200 from pot
*** SUMMARY ***
Total pot 200 | No rake
Seat 5: Kephren25 won 200


Winamax Poker - Tournament "KING 5 - Stade 1C" buyIn: Ticket only level: 2 - HandId: #469971603749339263-20-1424806118 - Holdem no limit (20/40) - 2015/02/24 19:28:38 UTC
Table: 'KING 5 - Stade 1C(109423791)#126' 9-max (real money) Seat #9 is the button
Seat 1: slidercc60 (3062)
Seat 2: AxelFooley (6826)
Seat 3: sabre_laser (4115)
Seat 4: catimini56 (5319)
Seat 5: Kephren25 (3765)
Seat 6: jackymichell (3955)
Seat 7: Criis89100 (5046)
Seat 8: _NyX_ (2481)
Seat 9: Girlypok59 (3910)
*** ANTE/BLINDS ***
slidercc60 posts small blind 20
AxelFooley posts big blind 40
Dealt to sabre_laser [4h Th]
*** PRE-FLOP *** 
sabre_laser folds
catimini56 calls 40
Kephren25 folds
jackymichell folds
Criis89100 calls 40
_NyX_ folds
Girlypok59 folds
slidercc60 folds
AxelFooley checks
*** FLOP *** [8d 9d 2c]
AxelFooley bets 70
catimini56 folds
Criis89100 calls 70
*** TURN *** [8d 9d 2c][Ah]
AxelFooley checks
Criis89100 checks
*** RIVER *** [8d 9d 2c Ah][Tc]
AxelFooley bets 140
Criis89100 folds
AxelFooley collected 420 from pot
*** SUMMARY ***
Total pot 420 | No rake
Board: [8d 9d 2c Ah Tc]
Seat 2: AxelFooley (big blind) won 420


Winamax Poker - Tournament "KING 5 - Stade 1C" buyIn: Ticket only level: 2 - HandId: #469971603749339263-21-1424806178 - Holdem no limit (20/40) - 2015/02/24 19:29:38 UTC
Table: 'KING 5 - Stade 1C(109423791)#126' 9-max (real money) Seat #1 is the button
Seat 1: slidercc60 (3042)
Seat 2: AxelFooley (6996)
Seat 3: sabre_laser (4115)
Seat 4: catimini56 (5279)
Seat 5: Kephren25 (3765)
Seat 6: jackymichell (3955)
Seat 7: Criis89100 (4936)
Seat 8: _NyX_ (2481)
Seat 9: Girlypok59 (3910)
*** ANTE/BLINDS ***
AxelFooley posts small blind 20
sabre_laser posts big blind 40
Dealt to sabre_laser [8d Ad]
*** PRE-FLOP *** 
catimini56 folds
Kephren25 folds
jackymichell folds
Criis89100 calls 40
_NyX_ calls 40
Girlypok59 calls 40
slidercc60 calls 40
AxelFooley calls 20
sabre_laser checks
*** FLOP *** [6s 7d 4c]
AxelFooley bets 40
sabre_laser calls 40
Criis89100 calls 40
_NyX_ raises 280 to 320
Girlypok59 folds
slidercc60 folds
AxelFooley folds
sabre_laser folds
Criis89100 calls 280
*** TURN *** [6s 7d 4c][3c]
Criis89100 checks
_NyX_ bets 640
Criis89100 folds
_NyX_ collected 1600 from pot
*** SUMMARY ***
Total pot 1600 | No rake
Board: [6s 7d 4c 3c]
Seat 8: _NyX_ won 1600


Winamax Poker - Tournament "KING 5 - Stade 1C" buyIn: Ticket only level: 2 - HandId: #469971603749339263-22-1424806311 - Holdem no limit (20/40) - 2015/02/24 19:31:51 UTC
Table: 'KING 5 - Stade 1C(109423791)#126' 9-max (real money) Seat #2 is the button
Seat 1: isc4rion (4028)
Seat 2: AxelFooley (6916)
Seat 3: sabre_laser (4035)
Seat 4: catimini56 (5279)
Seat 5: Kephren25 (3765)
Seat 6: jackymichell (3955)
Seat 7: Criis89100 (4576)
Seat 8: _NyX_ (3081)
Seat 9: Girlypok59 (3870)
*** ANTE/BLINDS ***
sabre_laser posts small blind 20
catimini56 posts big blind 40
Dealt to sabre_laser [4c 8d]
*** PRE-FLOP *** 
Kephren25 folds
jackymichell folds
Criis89100 folds
_NyX_ folds
Girlypok59 folds
isc4rion raises 60 to 100
AxelFooley calls 100
sabre_laser folds
catimini56 calls 60
*** FLOP *** [Qs Qc 9s]
catimini56 checks
isc4rion bets 120
AxelFooley folds
catimini56 folds
isc4rion collected 440 from pot
*** SUMMARY ***
Total pot 440 | No rake
Board: [Qs Qc 9s]
Seat 1: isc4rion won 440


Winamax Poker - Tournament "KING 5 - Stade 1C" buyIn: Ticket only level: 2 - HandId: #469971603749339263-23-1424806374 - Holdem no limit (20/40) - 2015/02/24 19:32:54 UTC
Table: 'KING 5 - Stade 1C(109423791)#126' 9-max (real money) Seat #3 is the button
Seat 1: isc4rion (4248)
Seat 2: AxelFooley (6816)
Seat 3: sabre_laser (4015)
Seat 4: catimini56 (5179)
Seat 5: Kephren25 (3765)
Seat 6: jackymichell (3955)
Seat 7: Criis89100 (4576)
Seat 8: _NyX_ (3081)
Seat 9: Girlypok59 (3870)
*** ANTE/BLINDS ***
catimini56 posts small blind 20
Kephren25 posts big blind 40
Dealt to sabre_laser [8s 2s]
*** PRE-FLOP *** 
jackymichell folds
Criis89100 calls 40
_NyX_ folds
Girlypok59 folds
isc4rion raises 80 to 120
AxelFooley folds
sabre_laser folds
catimini56 folds
Kephren25 calls 80
Criis89100 folds
*** FLOP *** [Td 3d 7c]
Kephren25 bets 200
isc4rion raises 320 to 520
Kephren25 folds
isc4rion collected 1020 from pot
*** SUMMARY ***
Total pot 1020 | No rake
Board: [Td 3d 7c]
Seat 1: isc4rion won 1020


Winamax Poker - Tournament "KING 5 - Stade 1C" buyIn: Ticket only level: 2 - HandId: #469971603749339263-24-1424806461 - Holdem no limit (20/40) - 2015/02/24 19:34:21 UTC
Table: 'KING 5 - Stade 1C(109423791)#126' 9-max (real money) Seat #4 is the button
Seat 1: isc4rion (4628)
Seat 2: AxelFooley (6816)
Seat 3: sabre_laser (4015)
Seat 4: catimini56 (5159)
Seat 5: Kephren25 (3445)
Seat 6: jackymichell (3955)
Seat 7: Criis89100 (4536)
Seat 8: _NyX_ (3081)
Seat 9: Girlypok59 (3870)
*** ANTE/BLINDS ***
Kephren25 posts small blind 20
jackymichell posts big blind 40
Dealt to sabre_laser [Kh 3d]
*** PRE-FLOP *** 
Criis89100 calls 40
_NyX_ folds
Girlypok59 raises 80 to 120
isc4rion folds
AxelFooley folds
sabre_laser folds
catimini56 folds
Kephren25 folds
jackymichell folds
Criis89100 calls 80
*** FLOP *** [9s Ts 8c]
Criis89100 bets 40
Girlypok59 raises 190 to 230
Criis89100 calls 190
*** TURN *** [9s Ts 8c][9d]
Criis89100 checks
Girlypok59 bets 380
Criis89100 calls 380
*** RIVER *** [9s Ts 8c 9d][5s]
Criis89100 bets 760
Girlypok59 calls 760
*** SHOW DOWN ***
Criis89100 shows [Th 7h] (Two pairs : Tens and 9)
Girlypok59 shows [Qh Qd] (Two pairs : Queens and 9)
Girlypok59 collected 3040 from pot
*** SUMMARY ***
Total pot 3040 | No rake
Board: [9s Ts 8c 9d 5s]
Seat 7: Criis89100 showed [Th 7h] and lost with Two pairs : Tens and 9
Seat 9: Girlypok59 showed [Qh Qd] and won 3040 with Two pairs : Queens and 9


Winamax Poker - Tournament "KING 5 - Stade 1C" buyIn: Ticket only level: 3 - HandId: #469971603749339263-25-1424806532 - Holdem no limit (30/60) - 2015/02/24 19:35:32 UTC
Table: 'KING 5 - Stade 1C(109423791)#126' 9-max (real money) Seat #5 is the button
Seat 1: isc4rion (4628)
Seat 2: AxelFooley (6816)
Seat 3: sabre_laser (4015)
Seat 4: catimini56 (5159)
Seat 5: Kephren25 (3425)
Seat 6: jackymichell (3915)
Seat 7: Criis89100 (3046)
Seat 8: _NyX_ (3081)
Seat 9: Girlypok59 (5420)
*** ANTE/BLINDS ***
jackymichell posts small blind 30
Criis89100 posts big blind 60
Dealt to sabre_laser [3s 3c]
*** PRE-FLOP *** 
_NyX_ folds
Girlypok59 folds
isc4rion raises 60 to 120
AxelFooley folds
sabre_laser calls 120
catimini56 calls 120
Kephren25 folds
jackymichell folds
Criis89100 calls 60
*** FLOP *** [4d 8c Qs]
Criis89100 checks
isc4rion checks
sabre_laser bets 510
catimini56 calls 510
Criis89100 folds
isc4rion folds
*** TURN *** [4d 8c Qs][Jh]
sabre_laser bets 765
catimini56 raises 765 to 1530
sabre_laser folds
catimini56 collected 3825 from pot
*** SUMMARY ***
Total pot 3825 | No rake
Board: [4d 8c Qs Jh]
Seat 4: catimini56 won 3825


Winamax Poker - Tournament "KING 5 - Stade 1C" buyIn: Ticket only level: 3 - HandId: #469971603749339263-26-1424806615 - Holdem no limit (30/60) - 2015/02/24 19:36:55 UTC
Table: 'KING 5 - Stade 1C(109423791)#126' 9-max (real money) Seat #6 is the button
Seat 1: isc4rion (4508)
Seat 2: AxelFooley (6816)
Seat 3: sabre_laser (2620)
Seat 4: catimini56 (6824)
Seat 5: Kephren25 (3425)
Seat 6: jackymichell (3885)
Seat 7: Criis89100 (2926)
Seat 8: _NyX_ (3081)
Seat 9: Girlypok59 (5420)
*** ANTE/BLINDS ***
Criis89100 posts small blind 30
_NyX_ posts big blind 60
Dealt to sabre_laser [Kc 4d]
*** PRE-FLOP *** 
Girlypok59 folds
isc4rion folds
AxelFooley calls 60
sabre_laser folds
catimini56 folds
Kephren25 folds
jackymichell folds
Criis89100 calls 30
_NyX_ checks
*** FLOP *** [5s Th Qc]
Criis89100 checks
_NyX_ checks
AxelFooley checks
*** TURN *** [5s Th Qc][8s]
Criis89100 bets 60
_NyX_ calls 60
AxelFooley folds
*** RIVER *** [5s Th Qc 8s][6s]
Criis89100 checks
_NyX_ checks
*** SHOW DOWN ***
Criis89100 shows [8c Kh] (One pair : 8)
_NyX_ shows [9c Ts] (One pair : Tens)
_NyX_ collected 300 from pot
*** SUMMARY ***
Total pot 300 | No rake
Board: [5s Th Qc 8s 6s]
Seat 7: Criis89100 (small blind) showed [8c Kh] and lost with One pair : 8
Seat 8: _NyX_ (big blind) showed [9c Ts] and won 300 with One pair : Tens


Winamax Poker - Tournament "KING 5 - Stade 1C" buyIn: Ticket only level: 3 - HandId: #469971603749339263-27-1424806667 - Holdem no limit (30/60) - 2015/02/24 19:37:47 UTC
Table: 'KING 5 - Stade 1C(109423791)#126' 9-max (real money) Seat #7 is the button
Seat 1: isc4rion (4508)
Seat 2: AxelFooley (6756)
Seat 3: sabre_laser (2620)
Seat 4: catimini56 (6824)
Seat 5: Kephren25 (3425)
Seat 6: jackymichell (3885)
Seat 7: Criis89100 (2806)
Seat 8: _NyX_ (3261)
Seat 9: Girlypok59 (5420)
*** ANTE/BLINDS ***
_NyX_ posts small blind 30
Girlypok59 posts big blind 60
Dealt to sabre_laser [Qs 3s]
*** PRE-FLOP *** 
isc4rion folds
AxelFooley folds
sabre_laser folds
catimini56 raises 90 to 150
Kephren25 folds
jackymichell folds
Criis89100 folds
_NyX_ folds
Girlypok59 raises 90 to 240
catimini56 calls 90
*** FLOP *** [Th 8c Ks]
Girlypok59 bets 510
catimini56 folds
Girlypok59 collected 1020 from pot
*** SUMMARY ***
Total pot 1020 | No rake
Board: [Th 8c Ks]
Seat 9: Girlypok59 (big blind) won 1020


Winamax Poker - Tournament "KING 5 - Stade 1C" buyIn: Ticket only level: 3 - HandId: #469971603749339263-28-1424806700 - Holdem no limit (30/60) - 2015/02/24 19:38:20 UTC
Table: 'KING 5 - Stade 1C(109423791)#126' 9-max (real money) Seat #8 is the button
Seat 1: isc4rion (4508)
Seat 2: AxelFooley (6756)
Seat 3: sabre_laser (2620)
Seat 4: catimini56 (6584)
Seat 5: Kephren25 (3425)
Seat 6: jackymichell (3885)
Seat 7: Criis89100 (2806)
Seat 8: _NyX_ (3231)
Seat 9: Girlypok59 (5690)
*** ANTE/BLINDS ***
Girlypok59 posts small blind 30
isc4rion posts big blind 60
Dealt to sabre_laser [Ts 6c]
*** PRE-FLOP *** 
AxelFooley folds
sabre_laser folds
catimini56 folds
Kephren25 raises 60 to 120
jackymichell folds
Criis89100 calls 120
_NyX_ folds
Girlypok59 calls 90
isc4rion calls 60
*** FLOP *** [4c 8h Ad]
Girlypok59 checks
isc4rion checks
Kephren25 bets 60
Criis89100 calls 60
Girlypok59 calls 60
isc4rion calls 60
*** TURN *** [4c 8h Ad][3c]
Girlypok59 checks
isc4rion checks
Kephren25 checks
Criis89100 checks
*** RIVER *** [4c 8h Ad 3c][8d]
Girlypok59 checks
isc4rion checks
Kephren25 checks
Criis89100 checks
*** SHOW DOWN ***
isc4rion shows [5s 7h] (One pair : 8)
Kephren25 shows [Kc Qh] (One pair : 8)
Criis89100 shows [Kd Jd] (One pair : 8)
Girlypok59 shows [2h 2s] (Two pairs : 8 and 2)
Girlypok59 collected 720 from pot
*** SUMMARY ***
Total pot 720 | No rake
Board: [4c 8h Ad 3c 8d]
Seat 1: isc4rion (big blind) showed [5s 7h] and lost with One pair : 8
Seat 5: Kephren25 showed [Kc Qh] and lost with One pair : 8
Seat 7: Criis89100 showed [Kd Jd] and lost with One pair : 8
Seat 9: Girlypok59 (small blind) showed [2h 2s] and won 720 with Two pairs : 8 and 2


Winamax Poker - Tournament "KING 5 - Stade 1C" buyIn: Ticket only level: 3 - HandId: #469971603749339263-29-1424806784 - Holdem no limit (30/60) - 2015/02/24 19:39:44 UTC
Table: 'KING 5 - Stade 1C(109423791)#126' 9-max (real money) Seat #9 is the button
Seat 1: isc4rion (4328)
Seat 2: AxelFooley (6756)
Seat 3: sabre_laser (2620)
Seat 4: catimini56 (6584)
Seat 5: Kephren25 (3245)
Seat 6: jackymichell (3885)
Seat 7: Criis89100 (2626)
Seat 8: _NyX_ (3231)
Seat 9: Girlypok59 (6230)
*** ANTE/BLINDS ***
isc4rion posts small blind 30
AxelFooley posts big blind 60
Dealt to sabre_laser [9c As]
*** PRE-FLOP *** 
sabre_laser folds
catimini56 folds
Kephren25 folds
jackymichell folds
Criis89100 folds
_NyX_ calls 60
Girlypok59 calls 60
isc4rion calls 30
AxelFooley checks
*** FLOP *** [7s 2d 5d]
isc4rion checks
AxelFooley bets 60
_NyX_ folds
Girlypok59 calls 60
isc4rion folds
*** TURN *** [7s 2d 5d][9s]
AxelFooley checks
Girlypok59 bets 180
AxelFooley calls 180
*** RIVER *** [7s 2d 5d 9s][Th]
AxelFooley checks
Girlypok59 checks
*** SHOW DOWN ***
Girlypok59 shows [3c 3h] (One pair : 3)
AxelFooley shows [2h 9d] (Two pairs : 9 and 2)
AxelFooley collected 720 from pot
*** SUMMARY ***
Total pot 720 | No rake
Board: [7s 2d 5d 9s Th]
Seat 2: AxelFooley (big blind) showed [2h 9d] and won 720 with Two pairs : 9 and 2
Seat 9: Girlypok59 (button) showed [3c 3h] and lost with One pair : 3


Winamax Poker - Tournament "KING 5 - Stade 1C" buyIn: Ticket only level: 3 - HandId: #469971603749339263-30-1424806854 - Holdem no limit (30/60) - 2015/02/24 19:40:54 UTC
Table: 'KING 5 - Stade 1C(109423791)#126' 9-max (real money) Seat #1 is the button
Seat 1: isc4rion (4268)
Seat 2: AxelFooley (7176)
Seat 3: sabre_laser (2620)
Seat 4: catimini56 (6584)
Seat 5: Kephren25 (3245)
Seat 6: jackymichell (3885)
Seat 7: Criis89100 (2626)
Seat 8: _NyX_ (3171)
Seat 9: Girlypok59 (5930)
*** ANTE/BLINDS ***
AxelFooley posts small blind 30
sabre_laser posts big blind 60
Dealt to sabre_laser [8c Ad]
*** PRE-FLOP *** 
catimini56 folds
Kephren25 folds
jackymichell raises 150 to 210
Criis89100 folds
_NyX_ calls 210
Girlypok59 folds
isc4rion folds
AxelFooley folds
sabre_laser folds
*** FLOP *** [As 6c 6s]
jackymichell bets 510
_NyX_ folds
jackymichell collected 1020 from pot
*** SUMMARY ***
Total pot 1020 | No rake
Board: [As 6c 6s]
Seat 6: jackymichell won 1020


Winamax Poker - Tournament "KING 5 - Stade 1C" buyIn: Ticket only level: 3 - HandId: #469971603749339263-31-1424806901 - Holdem no limit (30/60) - 2015/02/24 19:41:41 UTC
Table: 'KING 5 - Stade 1C(109423791)#126' 9-max (real money) Seat #2 is the button
Seat 1: isc4rion (4268)
Seat 2: AxelFooley (7146)
Seat 3: sabre_laser (2560)
Seat 4: catimini56 (6584)
Seat 5: Kephren25 (3245)
Seat 6: jackymichell (4185)
Seat 7: Criis89100 (2626)
Seat 8: _NyX_ (2961)
Seat 9: Girlypok59 (5930)
*** ANTE/BLINDS ***
sabre_laser posts small blind 30
catimini56 posts big blind 60
Dealt to sabre_laser [Th Jd]
*** PRE-FLOP *** 
Kephren25 folds
jackymichell folds
Criis89100 folds
_NyX_ folds
Girlypok59 folds
isc4rion folds
AxelFooley calls 60
sabre_laser calls 30
catimini56 checks
*** FLOP *** [Js Qc Ad]
sabre_laser checks
catimini56 checks
AxelFooley checks
*** TURN *** [Js Qc Ad][Ac]
sabre_laser bets 90
catimini56 folds
AxelFooley raises 90 to 180
sabre_laser calls 90
*** RIVER *** [Js Qc Ad Ac][5d]
sabre_laser bets 210
AxelFooley calls 210
*** SHOW DOWN ***
AxelFooley shows [7h 7s] (Two pairs : Aces and 7)
sabre_laser shows [Th Jd] (Two pairs : Aces and Jacks)
sabre_laser collected 960 from pot
*** SUMMARY ***
Total pot 960 | No rake
Board: [Js Qc Ad Ac 5d]
Seat 2: AxelFooley (button) showed [7h 7s] and lost with Two pairs : Aces and 7
Seat 3: sabre_laser (small blind) showed [Th Jd] and won 960 with Two pairs : Aces and Jacks


Winamax Poker - Tournament "KING 5 - Stade 1C" buyIn: Ticket only level: 4 - HandId: #469971603749339263-32-1424806991 - Holdem no limit (40/80) - 2015/02/24 19:43:11 UTC
Table: 'KING 5 - Stade 1C(109423791)#126' 9-max (real money) Seat #3 is the button
Seat 1: isc4rion (4268)
Seat 2: AxelFooley (6696)
Seat 3: sabre_laser (3070)
Seat 4: catimini56 (6524)
Seat 5: Kephren25 (3245)
Seat 6: jackymichell (4185)
Seat 7: Criis89100 (2626)
Seat 8: _NyX_ (2961)
Seat 9: Girlypok59 (5930)
*** ANTE/BLINDS ***
catimini56 posts small blind 40
Kephren25 posts big blind 80
Dealt to sabre_laser [6s Qs]
*** PRE-FLOP *** 
jackymichell folds
Criis89100 folds
_NyX_ folds
Girlypok59 folds
isc4rion folds
AxelFooley folds
sabre_laser folds
catimini56 calls 40
Kephren25 checks
*** FLOP *** [Jc 8s Js]
catimini56 checks
Kephren25 checks
*** TURN *** [Jc 8s Js][3c]
catimini56 checks
Kephren25 bets 80
catimini56 folds
Kephren25 collected 240 from pot
*** SUMMARY ***
Total pot 240 | No rake
Board: [Jc 8s Js 3c]
Seat 5: Kephren25 (big blind) won 240


Winamax Poker - Tournament "KING 5 - Stade 1C" buyIn: Ticket only level: 4 - HandId: #469971603749339263-33-1424807031 - Holdem no limit (40/80) - 2015/02/24 19:43:51 UTC
Table: 'KING 5 - Stade 1C(109423791)#126' 9-max (real money) Seat #4 is the button
Seat 1: isc4rion (4268)
Seat 2: AxelFooley (6696)
Seat 3: sabre_laser (3070)
Seat 4: catimini56 (6444)
Seat 5: Kephren25 (3325)
Seat 6: jackymichell (4185)
Seat 7: Criis89100 (2626)
Seat 8: _NyX_ (2961)
Seat 9: Girlypok59 (5930)
*** ANTE/BLINDS ***
Kephren25 posts small blind 40
jackymichell posts big blind 80
Dealt to sabre_laser [6c Kh]
*** PRE-FLOP *** 
Criis89100 folds
_NyX_ folds
Girlypok59 folds
isc4rion folds
AxelFooley folds
sabre_laser folds
catimini56 folds
Kephren25 calls 40
jackymichell checks
*** FLOP *** [6s 4h 5d]
Kephren25 checks
jackymichell checks
*** TURN *** [6s 4h 5d][As]
Kephren25 bets 80
jackymichell calls 80
*** RIVER *** [6s 4h 5d As][8s]
Kephren25 checks
jackymichell checks
*** SHOW DOWN ***
jackymichell shows [Jc 3d] (High card : Ace)
Kephren25 shows [Ad 3h] (One pair : Aces)
Kephren25 collected 320 from pot
*** SUMMARY ***
Total pot 320 | No rake
Board: [6s 4h 5d As 8s]
Seat 5: Kephren25 (small blind) showed [Ad 3h] and won 320 with One pair : Aces
Seat 6: jackymichell (big blind) showed [Jc 3d] and lost with High card : Ace


Winamax Poker - Tournament "KING 5 - Stade 1C" buyIn: Ticket only level: 4 - HandId: #469971603749339263-34-1424807088 - Holdem no limit (40/80) - 2015/02/24 19:44:48 UTC
Table: 'KING 5 - Stade 1C(109423791)#126' 9-max (real money) Seat #5 is the button
Seat 1: isc4rion (4268)
Seat 2: AxelFooley (6696)
Seat 3: sabre_laser (3070)
Seat 4: catimini56 (6444)
Seat 5: Kephren25 (3485)
Seat 6: jackymichell (4025)
Seat 7: Criis89100 (2626)
Seat 8: _NyX_ (2961)
Seat 9: Girlypok59 (5930)
*** ANTE/BLINDS ***
jackymichell posts small blind 40
Criis89100 posts big blind 80
Dealt to sabre_laser [Tc 9d]
*** PRE-FLOP *** 
_NyX_ folds
Girlypok59 folds
isc4rion calls 80
AxelFooley folds
sabre_laser folds
catimini56 folds
Kephren25 folds
jackymichell folds
Criis89100 checks
*** FLOP *** [6d 3d Kh]
Criis89100 checks
isc4rion bets 80
Criis89100 folds
isc4rion collected 280 from pot
*** SUMMARY ***
Total pot 280 | No rake
Board: [6d 3d Kh]
Seat 1: isc4rion won 280


Winamax Poker - Tournament "KING 5 - Stade 1C" buyIn: Ticket only level: 4 - HandId: #469971603749339263-35-1424807143 - Holdem no limit (40/80) - 2015/02/24 19:45:43 UTC
Table: 'KING 5 - Stade 1C(109423791)#126' 9-max (real money) Seat #6 is the button
Seat 1: isc4rion (4388)
Seat 2: AxelFooley (6696)
Seat 3: sabre_laser (3070)
Seat 4: catimini56 (6444)
Seat 5: Kephren25 (3485)
Seat 6: jackymichell (3985)
Seat 7: Criis89100 (2546)
Seat 8: _NyX_ (2961)
Seat 9: Girlypok59 (5930)
*** ANTE/BLINDS ***
Criis89100 posts small blind 40
_NyX_ posts big blind 80
Dealt to sabre_laser [2d Ks]
*** PRE-FLOP *** 
Girlypok59 folds
isc4rion calls 80
AxelFooley calls 80
sabre_laser folds
catimini56 folds
Kephren25 folds
jackymichell calls 80
Criis89100 calls 40
_NyX_ checks
*** FLOP *** [4h 7d Jh]
Criis89100 checks
_NyX_ checks
isc4rion bets 120
AxelFooley folds
jackymichell calls 120
Criis89100 folds
_NyX_ calls 120
*** TURN *** [4h 7d Jh][2s]
_NyX_ checks
isc4rion checks
jackymichell checks
*** RIVER *** [4h 7d Jh 2s][9s]
_NyX_ bets 507
isc4rion folds
jackymichell folds
_NyX_ collected 1267 from pot
*** SUMMARY ***
Total pot 1267 | No rake
Board: [4h 7d Jh 2s 9s]
Seat 8: _NyX_ (big blind) won 1267


Winamax Poker - Tournament "KING 5 - Stade 1C" buyIn: Ticket only level: 4 - HandId: #469971603749339263-36-1424807252 - Holdem no limit (40/80) - 2015/02/24 19:47:32 UTC
Table: 'KING 5 - Stade 1C(109423791)#126' 9-max (real money) Seat #7 is the button
Seat 1: isc4rion (4188)
Seat 2: AxelFooley (6616)
Seat 3: sabre_laser (3070)
Seat 4: catimini56 (6444)
Seat 5: Kephren25 (3485)
Seat 6: jackymichell (3785)
Seat 7: Criis89100 (2466)
Seat 8: _NyX_ (3521)
Seat 9: Girlypok59 (5930)
*** ANTE/BLINDS ***
_NyX_ posts small blind 40
Girlypok59 posts big blind 80
Dealt to sabre_laser [2d 8d]
*** PRE-FLOP *** 
isc4rion folds
AxelFooley folds
sabre_laser folds
catimini56 folds
Kephren25 folds
jackymichell calls 80
Criis89100 folds
_NyX_ calls 40
Girlypok59 raises 80 to 160
jackymichell calls 80
_NyX_ calls 80
*** FLOP *** [5s 6s Ad]
_NyX_ checks
Girlypok59 checks
jackymichell checks
*** TURN *** [5s 6s Ad][5h]
_NyX_ bets 200
Girlypok59 folds
jackymichell raises 280 to 480
_NyX_ calls 280
*** RIVER *** [5s 6s Ad 5h][2s]
_NyX_ checks
jackymichell bets 1200
_NyX_ folds
jackymichell collected 2640 from pot
*** SUMMARY ***
Total pot 2640 | No rake
Board: [5s 6s Ad 5h 2s]
Seat 6: jackymichell won 2640


Winamax Poker - Tournament "KING 5 - Stade 1C" buyIn: Ticket only level: 4 - HandId: #469971603749339263-37-1424807343 - Holdem no limit (40/80) - 2015/02/24 19:49:03 UTC
Table: 'KING 5 - Stade 1C(109423791)#126' 9-max (real money) Seat #8 is the button
Seat 1: isc4rion (4188)
Seat 2: AxelFooley (6616)
Seat 3: sabre_laser (3070)
Seat 4: catimini56 (6444)
Seat 5: Kephren25 (3485)
Seat 6: jackymichell (4585)
Seat 7: Criis89100 (2466)
Seat 8: _NyX_ (2881)
Seat 9: Girlypok59 (5770)
*** ANTE/BLINDS ***
Girlypok59 posts small blind 40
isc4rion posts big blind 80
Dealt to sabre_laser [Ad 3c]
*** PRE-FLOP *** 
AxelFooley folds
sabre_laser folds
catimini56 folds
Kephren25 folds
jackymichell calls 80
Criis89100 calls 80
_NyX_ raises 200 to 280
Girlypok59 folds
isc4rion folds
jackymichell calls 200
Criis89100 calls 200
*** FLOP *** [Jc Ts 5s]
jackymichell checks
Criis89100 checks
_NyX_ checks
*** TURN *** [Jc Ts 5s][7d]
jackymichell checks
Criis89100 bets 80
_NyX_ calls 80
jackymichell folds
*** RIVER *** [Jc Ts 5s 7d][9c]
Criis89100 checks
_NyX_ checks
*** SHOW DOWN ***
_NyX_ shows [Ac Qh] (High card : Ace)
Criis89100 shows [As 7s] (One pair : 7)
Criis89100 collected 1120 from pot
*** SUMMARY ***
Total pot 1120 | No rake
Board: [Jc Ts 5s 7d 9c]
Seat 7: Criis89100 showed [As 7s] and won 1120 with One pair : 7
Seat 8: _NyX_ (button) showed [Ac Qh] and lost with High card : Ace


Winamax Poker - Tournament "KING 5 - Stade 1C" buyIn: Ticket only level: 5 - HandId: #469971603749339263-38-1424807444 - Holdem no limit (60/120) - 2015/02/24 19:50:44 UTC
Table: 'KING 5 - Stade 1C(109423791)#126' 9-max (real money) Seat #9 is the button
Seat 1: isc4rion (4108)
Seat 2: AxelFooley (6616)
Seat 3: sabre_laser (3070)
Seat 4: catimini56 (6444)
Seat 5: Kephren25 (3485)
Seat 6: jackymichell (4305)
Seat 7: Criis89100 (3226)
Seat 8: _NyX_ (2521)
Seat 9: Girlypok59 (5730)
*** ANTE/BLINDS ***
isc4rion posts small blind 60
AxelFooley posts big blind 120
Dealt to sabre_laser [7h 7c]
*** PRE-FLOP *** 
sabre_laser raises 120 to 240
catimini56 folds
Kephren25 folds
jackymichell folds
Criis89100 folds
_NyX_ folds
Girlypok59 calls 240
isc4rion folds
AxelFooley calls 120
*** FLOP *** [8s 5s Qc]
AxelFooley checks
sabre_laser bets 720
Girlypok59 calls 720
AxelFooley folds
*** TURN *** [8s 5s Qc][3h]
sabre_laser checks
Girlypok59 bets 1110
sabre_laser folds
Girlypok59 collected 3330 from pot
*** SUMMARY ***
Total pot 3330 | No rake
Board: [8s 5s Qc 3h]
Seat 9: Girlypok59 (button) won 3330


Winamax Poker - Tournament "KING 5 - Stade 1C" buyIn: Ticket only level: 5 - HandId: #469971603749339263-39-1424807543 - Holdem no limit (60/120) - 2015/02/24 19:52:23 UTC
Table: 'KING 5 - Stade 1C(109423791)#126' 9-max (real money) Seat #1 is the button
Seat 1: isc4rion (4048)
Seat 2: AxelFooley (6376)
Seat 3: sabre_laser (2110)
Seat 4: catimini56 (6444)
Seat 5: Kephren25 (3485)
Seat 6: jackymichell (4305)
Seat 7: Criis89100 (3226)
Seat 8: _NyX_ (2521)
Seat 9: Girlypok59 (6990)
*** ANTE/BLINDS ***
AxelFooley posts small blind 60
sabre_laser posts big blind 120
Dealt to sabre_laser [Ac 5d]
*** PRE-FLOP *** 
catimini56 folds
Kephren25 folds
jackymichell folds
Criis89100 calls 120
_NyX_ folds
Girlypok59 folds
isc4rion folds
AxelFooley calls 60
sabre_laser checks
*** FLOP *** [9h Tc 3c]
AxelFooley bets 120
sabre_laser folds
Criis89100 folds
AxelFooley collected 480 from pot
*** SUMMARY ***
Total pot 480 | No rake
Board: [9h Tc 3c]
Seat 2: AxelFooley (small blind) won 480


Winamax Poker - Tournament "KING 5 - Stade 1C" buyIn: Ticket only level: 5 - HandId: #469971603749339263-40-1424807588 - Holdem no limit (60/120) - 2015/02/24 19:53:08 UTC
Table: 'KING 5 - Stade 1C(109423791)#126' 9-max (real money) Seat #2 is the button
Seat 1: isc4rion (4048)
Seat 2: AxelFooley (6616)
Seat 3: sabre_laser (1990)
Seat 4: catimini56 (6444)
Seat 5: Kephren25 (3485)
Seat 6: jackymichell (4305)
Seat 7: Criis89100 (3106)
Seat 8: _NyX_ (2521)
Seat 9: Girlypok59 (6990)
*** ANTE/BLINDS ***
sabre_laser posts small blind 60
catimini56 posts big blind 120
Dealt to sabre_laser [Td 2s]
*** PRE-FLOP *** 
Kephren25 folds
jackymichell folds
Criis89100 folds
_NyX_ folds
Girlypok59 raises 120 to 240
isc4rion calls 240
AxelFooley folds
sabre_laser folds
catimini56 calls 120
*** FLOP *** [Kd 7s 9d]
catimini56 checks
Girlypok59 bets 120
isc4rion folds
catimini56 calls 120
*** TURN *** [Kd 7s 9d][5d]
catimini56 checks
Girlypok59 bets 510
catimini56 calls 510
*** RIVER *** [Kd 7s 9d 5d][Js]
catimini56 checks
Girlypok59 checks
*** SHOW DOWN ***
catimini56 shows [Ad Qs] (High card : Ace)
Girlypok59 shows [Ts Tc] (One pair : Tens)
Girlypok59 collected 2040 from pot
*** SUMMARY ***
Total pot 2040 | No rake
Board: [Kd 7s 9d 5d Js]
Seat 4: catimini56 (big blind) showed [Ad Qs] and lost with High card : Ace
Seat 9: Girlypok59 showed [Ts Tc] and won 2040 with One pair : Tens


Winamax Poker - Tournament "KING 5 - Stade 1C" buyIn: Ticket only level: 5 - HandId: #469971603749339263-41-1424807650 - Holdem no limit (60/120) - 2015/02/24 19:54:10 UTC
Table: 'KING 5 - Stade 1C(109423791)#126' 9-max (real money) Seat #3 is the button
Seat 1: isc4rion (3808)
Seat 2: AxelFooley (6616)
Seat 3: sabre_laser (1930)
Seat 4: catimini56 (5574)
Seat 5: Kephren25 (3485)
Seat 6: jackymichell (4305)
Seat 7: Criis89100 (3106)
Seat 8: _NyX_ (2521)
Seat 9: Girlypok59 (8160)
*** ANTE/BLINDS ***
catimini56 posts small blind 60
Kephren25 posts big blind 120
Dealt to sabre_laser [5c 3h]
*** PRE-FLOP *** 
jackymichell folds
Criis89100 folds
_NyX_ folds
Girlypok59 calls 120
isc4rion folds
AxelFooley folds
sabre_laser folds
catimini56 folds
Kephren25 checks
*** FLOP *** [7c 3s Jh]
Kephren25 checks
Girlypok59 bets 300
Kephren25 folds
Girlypok59 collected 600 from pot
*** SUMMARY ***
Total pot 600 | No rake
Board: [7c 3s Jh]
Seat 9: Girlypok59 won 600


Winamax Poker - Tournament "KING 5 - Stade 1C" buyIn: Ticket only level: 5 - HandId: #469971603749339263-42-1424808002 - Holdem no limit (60/120) - 2015/02/24 20:00:02 UTC
Table: 'KING 5 - Stade 1C(109423791)#126' 9-max (real money) Seat #4 is the button
Seat 1: isc4rion (3808)
Seat 2: AxelFooley (6616)
Seat 3: sabre_laser (1930)
Seat 4: catimini56 (5514)
Seat 5: Kephren25 (3365)
Seat 6: jackymichell (4305)
Seat 7: Criis89100 (3106)
Seat 8: _NyX_ (2521)
Seat 9: Girlypok59 (8340)
*** ANTE/BLINDS ***
Kephren25 posts small blind 60
jackymichell posts big blind 120
Dealt to sabre_laser [Kc 3s]
*** PRE-FLOP *** 
Criis89100 folds
_NyX_ folds
Girlypok59 calls 120
isc4rion folds
AxelFooley folds
sabre_laser folds
catimini56 folds
Kephren25 calls 60
jackymichell checks
*** FLOP *** [7h 2d As]
Kephren25 bets 240
jackymichell folds
Girlypok59 folds
Kephren25 collected 600 from pot
*** SUMMARY ***
Total pot 600 | No rake
Board: [7h 2d As]
Seat 5: Kephren25 (small blind) won 600


Winamax Poker - Tournament "KING 5 - Stade 1C" buyIn: Ticket only level: 5 - HandId: #469971603749339263-43-1424808060 - Holdem no limit (60/120) - 2015/02/24 20:01:00 UTC
Table: 'KING 5 - Stade 1C(109423791)#126' 9-max (real money) Seat #5 is the button
Seat 1: isc4rion (3808)
Seat 2: AxelFooley (6616)
Seat 3: sabre_laser (1930)
Seat 4: catimini56 (5514)
Seat 5: Kephren25 (3605)
Seat 6: jackymichell (4185)
Seat 7: Criis89100 (3106)
Seat 8: _NyX_ (2521)
Seat 9: Girlypok59 (8220)
*** ANTE/BLINDS ***
jackymichell posts small blind 60
Criis89100 posts big blind 120
Dealt to sabre_laser [9c As]
*** PRE-FLOP *** 
_NyX_ folds
Girlypok59 folds
isc4rion folds
AxelFooley folds
sabre_laser folds
catimini56 raises 180 to 300
Kephren25 folds
jackymichell calls 240
Criis89100 folds
*** FLOP *** [Kd 8h 2d]
jackymichell checks
catimini56 bets 480
jackymichell folds
catimini56 collected 1200 from pot
*** SUMMARY ***
Total pot 1200 | No rake
Board: [Kd 8h 2d]
Seat 4: catimini56 won 1200


Winamax Poker - Tournament "KING 5 - Stade 1C" buyIn: Ticket only level: 5 - HandId: #469971603749339263-44-1424808115 - Holdem no limit (60/120) - 2015/02/24 20:01:55 UTC
Table: 'KING 5 - Stade 1C(109423791)#126' 9-max (real money) Seat #6 is the button
Seat 1: isc4rion (3808)
Seat 2: AxelFooley (6616)
Seat 3: sabre_laser (1930)
Seat 4: catimini56 (5934)
Seat 5: Kephren25 (3605)
Seat 6: jackymichell (3885)
Seat 7: Criis89100 (2986)
Seat 8: _NyX_ (2521)
Seat 9: Girlypok59 (8220)
*** ANTE/BLINDS ***
Criis89100 posts small blind 60
_NyX_ posts big blind 120
Dealt to sabre_laser [As 6h]
*** PRE-FLOP *** 
Girlypok59 folds
isc4rion folds
AxelFooley folds
sabre_laser folds
catimini56 folds
Kephren25 folds
jackymichell calls 120
Criis89100 calls 60
_NyX_ checks
*** FLOP *** [8s 6c Jh]
Criis89100 checks
_NyX_ bets 240
jackymichell calls 240
Criis89100 folds
*** TURN *** [8s 6c Jh][2c]
_NyX_ bets 840
jackymichell calls 840
*** RIVER *** [8s 6c Jh 2c][3s]
_NyX_ bets 1321 and is all-in
jackymichell folds
_NyX_ collected 3841 from pot
*** SUMMARY ***
Total pot 3841 | No rake
Board: [8s 6c Jh 2c 3s]
Seat 8: _NyX_ (big blind) won 3841


Winamax Poker - Tournament "KING 5 - Stade 1C" buyIn: Ticket only level: 5 - HandId: #469971603749339263-45-1424808185 - Holdem no limit (60/120) - 2015/02/24 20:03:05 UTC
Table: 'KING 5 - Stade 1C(109423791)#126' 9-max (real money) Seat #7 is the button
Seat 1: isc4rion (3808)
Seat 2: AxelFooley (6616)
Seat 3: sabre_laser (1930)
Seat 4: catimini56 (5934)
Seat 5: Kephren25 (3605)
Seat 6: jackymichell (2685)
Seat 7: Criis89100 (2866)
Seat 8: _NyX_ (3841)
Seat 9: Girlypok59 (8220)
*** ANTE/BLINDS ***
_NyX_ posts small blind 60
Girlypok59 posts big blind 120
Dealt to sabre_laser [3d 2d]
*** PRE-FLOP *** 
isc4rion folds
AxelFooley folds
sabre_laser folds
catimini56 folds
Kephren25 folds
jackymichell folds
Criis89100 calls 120
_NyX_ calls 60
Girlypok59 raises 120 to 240
Criis89100 calls 120
_NyX_ calls 120
*** FLOP *** [8d Ad Jh]
_NyX_ checks
Girlypok59 bets 720
Criis89100 folds
_NyX_ folds
Girlypok59 collected 1440 from pot
*** SUMMARY ***
Total pot 1440 | No rake
Board: [8d Ad Jh]
Seat 9: Girlypok59 (big blind) won 1440


Winamax Poker - Tournament "KING 5 - Stade 1C" buyIn: Ticket only level: 6 - HandId: #469971603749339263-46-1424808254 - Holdem no limit (15/75/150) - 2015/02/24 20:04:14 UTC
Table: 'KING 5 - Stade 1C(109423791)#126' 9-max (real money) Seat #8 is the button
Seat 1: isc4rion (3808)
Seat 2: AxelFooley (6616)
Seat 3: sabre_laser (1930)
Seat 4: catimini56 (5934)
Seat 5: Kephren25 (3605)
Seat 6: jackymichell (2685)
Seat 7: Criis89100 (2626)
Seat 8: _NyX_ (3601)
Seat 9: Girlypok59 (8700)
*** ANTE/BLINDS ***
Girlypok59 posts ante 15
isc4rion posts ante 15
AxelFooley posts ante 15
sabre_laser posts ante 15
catimini56 posts ante 15
Kephren25 posts ante 15
jackymichell posts ante 15
Criis89100 posts ante 15
_NyX_ posts ante 15
Girlypok59 posts small blind 75
isc4rion posts big blind 150
Dealt to sabre_laser [6h 2s]
*** PRE-FLOP *** 
AxelFooley folds
sabre_laser folds
catimini56 folds
Kephren25 raises 300 to 450
jackymichell folds
Criis89100 calls 450
_NyX_ folds
Girlypok59 calls 375
isc4rion folds
*** FLOP *** [3h Ad Qh]
Girlypok59 checks
Kephren25 checks
Criis89100 checks
*** TURN *** [3h Ad Qh][7d]
Girlypok59 bets 1635
Kephren25 folds
Criis89100 folds
Girlypok59 collected 3270 from pot
*** SUMMARY ***
Total pot 3270 | No rake
Board: [3h Ad Qh 7d]
Seat 9: Girlypok59 (small blind) won 3270


Winamax Poker - Tournament "KING 5 - Stade 1C" buyIn: Ticket only level: 6 - HandId: #469971603749339263-47-1424808344 - Holdem no limit (15/75/150) - 2015/02/24 20:05:44 UTC
Table: 'KING 5 - Stade 1C(109423791)#126' 9-max (real money) Seat #9 is the button
Seat 1: isc4rion (3643)
Seat 2: AxelFooley (6601)
Seat 3: sabre_laser (1915)
Seat 4: catimini56 (5919)
Seat 5: Kephren25 (3140)
Seat 6: jackymichell (2670)
Seat 7: Criis89100 (2161)
Seat 8: _NyX_ (3586)
Seat 9: Girlypok59 (9870)
*** ANTE/BLINDS ***
isc4rion posts ante 15
AxelFooley posts ante 15
sabre_laser posts ante 15
catimini56 posts ante 15
Kephren25 posts ante 15
jackymichell posts ante 15
Criis89100 posts ante 15
_NyX_ posts ante 15
Girlypok59 posts ante 15
isc4rion posts small blind 75
AxelFooley posts big blind 150
Dealt to sabre_laser [Qh 9h]
*** PRE-FLOP *** 
sabre_laser folds
catimini56 folds
Kephren25 folds
jackymichell folds
Criis89100 folds
_NyX_ folds
Girlypok59 calls 150
isc4rion calls 75
AxelFooley checks
*** FLOP *** [Ac Qd 7h]
isc4rion checks
AxelFooley checks
Girlypok59 bets 292
isc4rion folds
AxelFooley folds
Girlypok59 collected 877 from pot
*** SUMMARY ***
Total pot 877 | No rake
Board: [Ac Qd 7h]
Seat 9: Girlypok59 (button) won 877


Winamax Poker - Tournament "KING 5 - Stade 1C" buyIn: Ticket only level: 6 - HandId: #469971603749339263-48-1424808397 - Holdem no limit (15/75/150) - 2015/02/24 20:06:37 UTC
Table: 'KING 5 - Stade 1C(109423791)#126' 9-max (real money) Seat #1 is the button
Seat 1: isc4rion (3478)
Seat 2: AxelFooley (6436)
Seat 3: sabre_laser (1900)
Seat 4: catimini56 (5904)
Seat 5: Kephren25 (3125)
Seat 6: jackymichell (2655)
Seat 7: Criis89100 (2146)
Seat 8: _NyX_ (3571)
Seat 9: Girlypok59 (10290)
*** ANTE/BLINDS ***
AxelFooley posts ante 15
sabre_laser posts ante 15
isc4rion posts ante 15
catimini56 posts ante 15
Kephren25 posts ante 15
jackymichell posts ante 15
Criis89100 posts ante 15
_NyX_ posts ante 15
Girlypok59 posts ante 15
AxelFooley posts small blind 75
sabre_laser posts big blind 150
Dealt to sabre_laser [5d Jd]
*** PRE-FLOP *** 
catimini56 folds
Kephren25 folds
jackymichell raises 225 to 375
Criis89100 folds
_NyX_ folds
Girlypok59 folds
isc4rion calls 375
AxelFooley folds
sabre_laser folds
*** FLOP *** [As Th 5h]
jackymichell bets 825
isc4rion folds
jackymichell collected 1935 from pot
*** SUMMARY ***
Total pot 1935 | No rake
Board: [As Th 5h]
Seat 6: jackymichell won 1935


Winamax Poker - Tournament "KING 5 - Stade 1C" buyIn: Ticket only level: 6 - HandId: #469971603749339263-49-1424808447 - Holdem no limit (15/75/150) - 2015/02/24 20:07:27 UTC
Table: 'KING 5 - Stade 1C(109423791)#126' 9-max (real money) Seat #2 is the button
Seat 1: isc4rion (3088)
Seat 2: AxelFooley (6346)
Seat 3: sabre_laser (1735)
Seat 4: catimini56 (5889)
Seat 5: Kephren25 (3110)
Seat 6: jackymichell (3375)
Seat 7: Criis89100 (2131)
Seat 8: _NyX_ (3556)
Seat 9: Girlypok59 (10275)
*** ANTE/BLINDS ***
sabre_laser posts ante 15
catimini56 posts ante 15
isc4rion posts ante 15
AxelFooley posts ante 15
Kephren25 posts ante 15
jackymichell posts ante 15
Criis89100 posts ante 15
_NyX_ posts ante 15
Girlypok59 posts ante 15
sabre_laser posts small blind 75
catimini56 posts big blind 150
Dealt to sabre_laser [6d 9h]
*** PRE-FLOP *** 
Kephren25 folds
jackymichell raises 225 to 375
Criis89100 folds
_NyX_ folds
Girlypok59 folds
isc4rion folds
AxelFooley folds
sabre_laser folds
catimini56 folds
jackymichell collected 735 from pot
*** SUMMARY ***
Total pot 735 | No rake
Seat 6: jackymichell won 735


Winamax Poker - Tournament "KING 5 - Stade 1C" buyIn: Ticket only level: 6 - HandId: #469971603749339263-50-1424808479 - Holdem no limit (15/75/150) - 2015/02/24 20:07:59 UTC
Table: 'KING 5 - Stade 1C(109423791)#126' 9-max (real money) Seat #3 is the button
Seat 1: isc4rion (3073)
Seat 2: didou68 (4195)
Seat 3: sabre_laser (1645)
Seat 4: catimini56 (5724)
Seat 5: Kephren25 (3095)
Seat 6: jackymichell (3720)
Seat 7: Criis89100 (2116)
Seat 8: _NyX_ (3541)
Seat 9: Girlypok59 (10260)
*** ANTE/BLINDS ***
catimini56 posts ante 15
Kephren25 posts ante 15
isc4rion posts ante 15
didou68 posts ante 15
sabre_laser posts ante 15
jackymichell posts ante 15
Criis89100 posts ante 15
_NyX_ posts ante 15
Girlypok59 posts ante 15
catimini56 posts small blind 75
Kephren25 posts big blind 150
Dealt to sabre_laser [8c Js]
*** PRE-FLOP *** 
jackymichell raises 225 to 375
Criis89100 folds
_NyX_ folds
Girlypok59 folds
isc4rion folds
didou68 calls 375
sabre_laser folds
catimini56 folds
Kephren25 folds
*** FLOP *** [6c 9d 7s]
jackymichell checks
didou68 checks
*** TURN *** [6c 9d 7s][3s]
jackymichell checks
didou68 checks
*** RIVER *** [6c 9d 7s 3s][Qh]
jackymichell bets 450
didou68 calls 450
*** SHOW DOWN ***
didou68 shows [2d 2c] (One pair : 2)
jackymichell shows [Ts Qd] (One pair : Queens)
jackymichell collected 2010 from pot
*** SUMMARY ***
Total pot 2010 | No rake
Board: [6c 9d 7s 3s Qh]
Seat 2: didou68 showed [2d 2c] and lost with One pair : 2
Seat 6: jackymichell showed [Ts Qd] and won 2010 with One pair : Queens


Winamax Poker - Tournament "KING 5 - Stade 1C" buyIn: Ticket only level: 6 - HandId: #469971603749339263-51-1424808532 - Holdem no limit (15/75/150) - 2015/02/24 20:08:52 UTC
Table: 'KING 5 - Stade 1C(109423791)#126' 9-max (real money) Seat #4 is the button
Seat 1: isc4rion (3058)
Seat 2: didou68 (3355)
Seat 3: sabre_laser (1630)
Seat 4: catimini56 (5634)
Seat 5: Kephren25 (2930)
Seat 6: jackymichell (4890)
Seat 7: Criis89100 (2101)
Seat 8: _NyX_ (3526)
Seat 9: Girlypok59 (10245)
*** ANTE/BLINDS ***
Kephren25 posts ante 15
jackymichell posts ante 15
isc4rion posts ante 15
didou68 posts ante 15
sabre_laser posts ante 15
catimini56 posts ante 15
Criis89100 posts ante 15
_NyX_ posts ante 15
Girlypok59 posts ante 15
Kephren25 posts small blind 75
jackymichell posts big blind 150
Dealt to sabre_laser [Qd 2d]
*** PRE-FLOP *** 
Criis89100 folds
_NyX_ folds
Girlypok59 calls 150
isc4rion folds
didou68 folds
sabre_laser folds
catimini56 folds
Kephren25 raises 2765 to 2915 and is all-in
jackymichell calls 2765
Girlypok59 folds
*** FLOP *** [Kd 9d 4h]
*** TURN *** [Kd 9d 4h][4d]
*** RIVER *** [Kd 9d 4h 4d][7c]
*** SHOW DOWN ***
jackymichell shows [Td Ac] (One pair : 4)
Kephren25 shows [Qc Qs] (Two pairs : Queens and 4)
Kephren25 collected 6115 from pot
*** SUMMARY ***
Total pot 6115 | No rake
Board: [Kd 9d 4h 4d 7c]
Seat 5: Kephren25 (small blind) showed [Qc Qs] and won 6115 with Two pairs : Queens and 4
Seat 6: jackymichell (big blind) showed [Td Ac] and lost with One pair : 4


Winamax Poker - Tournament "KING 5 - Stade 1C" buyIn: Ticket only level: 6 - HandId: #469971603749339263-52-1424808566 - Holdem no limit (15/75/150) - 2015/02/24 20:09:26 UTC
Table: 'KING 5 - Stade 1C(109423791)#126' 9-max (real money) Seat #5 is the button
Seat 1: isc4rion (3043)
Seat 2: didou68 (3340)
Seat 3: sabre_laser (1615)
Seat 4: catimini56 (5619)
Seat 5: Kephren25 (6115)
Seat 6: jackymichell (1960)
Seat 7: Criis89100 (2086)
Seat 8: _NyX_ (3511)
Seat 9: Girlypok59 (10080)
*** ANTE/BLINDS ***
jackymichell posts ante 15
Criis89100 posts ante 15
isc4rion posts ante 15
didou68 posts ante 15
sabre_laser posts ante 15
catimini56 posts ante 15
Kephren25 posts ante 15
_NyX_ posts ante 15
Girlypok59 posts ante 15
jackymichell posts small blind 75
Criis89100 posts big blind 150
Dealt to sabre_laser [2d 6d]
*** PRE-FLOP *** 
_NyX_ folds
Girlypok59 folds
isc4rion folds
didou68 folds
sabre_laser folds
catimini56 folds
Kephren25 folds
jackymichell calls 75
Criis89100 checks
*** FLOP *** [2c 4h Ks]
jackymichell checks
Criis89100 bets 150
jackymichell calls 150
*** TURN *** [2c 4h Ks][4s]
jackymichell checks
Criis89100 checks
*** RIVER *** [2c 4h Ks 4s][8h]
jackymichell checks
Criis89100 checks
*** SHOW DOWN ***
Criis89100 shows [2h 3d] (Two pairs : 4 and 2)
jackymichell shows [Kd Kh] (Full of Kings and 4)
jackymichell collected 735 from pot
*** SUMMARY ***
Total pot 735 | No rake
Board: [2c 4h Ks 4s 8h]
Seat 6: jackymichell (small blind) showed [Kd Kh] and won 735 with Full of Kings and 4
Seat 7: Criis89100 (big blind) showed [2h 3d] and lost with Two pairs : 4 and 2


Winamax Poker - Tournament "KING 5 - Stade 1C" buyIn: Ticket only level: 6 - HandId: #469971603749339263-53-1424808632 - Holdem no limit (15/75/150) - 2015/02/24 20:10:32 UTC
Table: 'KING 5 - Stade 1C(109423791)#126' 9-max (real money) Seat #6 is the button
Seat 1: isc4rion (3028)
Seat 2: didou68 (3325)
Seat 3: sabre_laser (1600)
Seat 4: catimini56 (5604)
Seat 5: Kephren25 (6100)
Seat 6: jackymichell (2380)
Seat 7: Criis89100 (1771)
Seat 8: _NyX_ (3496)
Seat 9: Girlypok59 (10065)
*** ANTE/BLINDS ***
Criis89100 posts ante 15
_NyX_ posts ante 15
isc4rion posts ante 15
didou68 posts ante 15
sabre_laser posts ante 15
catimini56 posts ante 15
Kephren25 posts ante 15
jackymichell posts ante 15
Girlypok59 posts ante 15
Criis89100 posts small blind 75
_NyX_ posts big blind 150
Dealt to sabre_laser [Kh 4c]
*** PRE-FLOP *** 
Girlypok59 folds
isc4rion folds
didou68 raises 180 to 330
sabre_laser folds
catimini56 folds
Kephren25 folds
jackymichell folds
Criis89100 folds
_NyX_ folds
didou68 collected 690 from pot
*** SUMMARY ***
Total pot 690 | No rake
Seat 2: didou68 won 690


Winamax Poker - Tournament "KING 5 - Stade 1C" buyIn: Ticket only level: 6 - HandId: #469971603749339263-54-1424808675 - Holdem no limit (15/75/150) - 2015/02/24 20:11:15 UTC
Table: 'KING 5 - Stade 1C(109423791)#126' 9-max (real money) Seat #7 is the button
Seat 1: isc4rion (3013)
Seat 2: didou68 (3670)
Seat 3: sabre_laser (1585)
Seat 4: catimini56 (5589)
Seat 5: Kephren25 (6085)
Seat 6: jackymichell (2365)
Seat 7: Criis89100 (1681)
Seat 8: _NyX_ (3331)
Seat 9: Girlypok59 (10050)
*** ANTE/BLINDS ***
_NyX_ posts ante 15
Girlypok59 posts ante 15
isc4rion posts ante 15
didou68 posts ante 15
sabre_laser posts ante 15
catimini56 posts ante 15
Kephren25 posts ante 15
jackymichell posts ante 15
Criis89100 posts ante 15
_NyX_ posts small blind 75
Girlypok59 posts big blind 150
Dealt to sabre_laser [Ad 4d]
*** PRE-FLOP *** 
isc4rion folds
didou68 folds
sabre_laser folds
catimini56 folds
Kephren25 folds
jackymichell folds
Criis89100 folds
_NyX_ calls 75
Girlypok59 raises 300 to 450
_NyX_ folds
Girlypok59 collected 735 from pot
*** SUMMARY ***
Total pot 735 | No rake
Seat 9: Girlypok59 (big blind) won 735


Winamax Poker - Tournament "KING 5 - Stade 1C" buyIn: Ticket only level: 7 - HandId: #469971603749339263-55-1424808720 - Holdem no limit (20/100/200) - 2015/02/24 20:12:00 UTC
Table: 'KING 5 - Stade 1C(109423791)#126' 9-max (real money) Seat #8 is the button
Seat 1: isc4rion (2998)
Seat 2: didou68 (3655)
Seat 3: sabre_laser (1570)
Seat 4: catimini56 (5574)
Seat 5: Kephren25 (6070)
Seat 6: jackymichell (2350)
Seat 7: Criis89100 (1666)
Seat 8: _NyX_ (3166)
Seat 9: Girlypok59 (10320)
*** ANTE/BLINDS ***
Girlypok59 posts ante 20
isc4rion posts ante 20
didou68 posts ante 20
sabre_laser posts ante 20
catimini56 posts ante 20
Kephren25 posts ante 20
jackymichell posts ante 20
Criis89100 posts ante 20
_NyX_ posts ante 20
Girlypok59 posts small blind 100
isc4rion posts big blind 200
Dealt to sabre_laser [7h 7c]
*** PRE-FLOP *** 
didou68 folds
sabre_laser raises 1350 to 1550 and is all-in
catimini56 folds
Kephren25 folds
jackymichell folds
Criis89100 folds
_NyX_ folds
Girlypok59 folds
isc4rion folds
sabre_laser collected 2030 from pot
*** SUMMARY ***
Total pot 2030 | No rake
Seat 3: sabre_laser won 2030


Winamax Poker - Tournament "KING 5 - Stade 1C" buyIn: Ticket only level: 7 - HandId: #469971603749339263-56-1424808763 - Holdem no limit (20/100/200) - 2015/02/24 20:12:43 UTC
Table: 'KING 5 - Stade 1C(109423791)#126' 9-max (real money) Seat #9 is the button
Seat 1: isc4rion (2778)
Seat 2: didou68 (3635)
Seat 3: sabre_laser (2030)
Seat 4: catimini56 (5554)
Seat 5: Kephren25 (6050)
Seat 6: jackymichell (2330)
Seat 7: Criis89100 (1646)
Seat 8: _NyX_ (3146)
Seat 9: Girlypok59 (10200)
*** ANTE/BLINDS ***
isc4rion posts ante 20
didou68 posts ante 20
sabre_laser posts ante 20
catimini56 posts ante 20
Kephren25 posts ante 20
jackymichell posts ante 20
Criis89100 posts ante 20
_NyX_ posts ante 20
Girlypok59 posts ante 20
isc4rion posts small blind 100
didou68 posts big blind 200
Dealt to sabre_laser [9s 6s]
*** PRE-FLOP *** 
sabre_laser folds
catimini56 folds
Kephren25 folds
jackymichell folds
Criis89100 folds
_NyX_ folds
Girlypok59 calls 200
isc4rion raises 2558 to 2758 and is all-in
didou68 folds
Girlypok59 folds
isc4rion collected 3338 from pot
*** SUMMARY ***
Total pot 3338 | No rake
Seat 1: isc4rion (small blind) won 3338


Winamax Poker - Tournament "KING 5 - Stade 1C" buyIn: Ticket only level: 7 - HandId: #469971603749339263-57-1424808816 - Holdem no limit (20/100/200) - 2015/02/24 20:13:36 UTC
Table: 'KING 5 - Stade 1C(109423791)#126' 9-max (real money) Seat #1 is the button
Seat 1: isc4rion (3338)
Seat 2: didou68 (3415)
Seat 3: sabre_laser (2010)
Seat 4: catimini56 (5534)
Seat 5: Kephren25 (6030)
Seat 6: jackymichell (2310)
Seat 7: Criis89100 (1626)
Seat 8: _NyX_ (3126)
Seat 9: Girlypok59 (9980)
*** ANTE/BLINDS ***
didou68 posts ante 20
sabre_laser posts ante 20
isc4rion posts ante 20
catimini56 posts ante 20
Kephren25 posts ante 20
jackymichell posts ante 20
Criis89100 posts ante 20
_NyX_ posts ante 20
Girlypok59 posts ante 20
didou68 posts small blind 100
sabre_laser posts big blind 200
Dealt to sabre_laser [3c 5h]
*** PRE-FLOP *** 
catimini56 raises 200 to 400
Kephren25 folds
jackymichell calls 400
Criis89100 calls 400
_NyX_ folds
Girlypok59 folds
isc4rion folds
didou68 folds
sabre_laser folds
*** FLOP *** [Th Jd 9d]
catimini56 bets 1120
jackymichell folds
Criis89100 raises 86 to 1206 and is all-in
catimini56 calls 86
*** TURN *** [Th Jd 9d][2s]
*** RIVER *** [Th Jd 9d 2s][7s]
*** SHOW DOWN ***
Criis89100 shows [Ah Qc] (High card : Ace)
catimini56 shows [Qs Qh] (One pair : Queens)
catimini56 collected 4092 from pot
*** SUMMARY ***
Total pot 4092 | No rake
Board: [Th Jd 9d 2s 7s]
Seat 4: catimini56 showed [Qs Qh] and won 4092 with One pair : Queens
Seat 7: Criis89100 showed [Ah Qc] and lost with High card : Ace


Winamax Poker - Tournament "KING 5 - Stade 1C" buyIn: Ticket only level: 7 - HandId: #469971603749339263-58-1424808911 - Holdem no limit (20/100/200) - 2015/02/24 20:15:11 UTC
Table: 'KING 5 - Stade 1C(109423791)#126' 9-max (real money) Seat #2 is the button
Seat 1: isc4rion (3318)
Seat 2: didou68 (3295)
Seat 3: sabre_laser (1790)
Seat 4: catimini56 (8000)
Seat 5: Kephren25 (6010)
Seat 6: jackymichell (1890)
Seat 8: _NyX_ (3106)
Seat 9: Girlypok59 (9960)
*** ANTE/BLINDS ***
sabre_laser posts ante 20
catimini56 posts ante 20
isc4rion posts ante 20
didou68 posts ante 20
Kephren25 posts ante 20
jackymichell posts ante 20
_NyX_ posts ante 20
Girlypok59 posts ante 20
sabre_laser posts small blind 100
catimini56 posts big blind 200
Dealt to sabre_laser [Kh 2c]
*** PRE-FLOP *** 
Kephren25 folds
jackymichell calls 200
_NyX_ folds
Girlypok59 folds
isc4rion calls 200
didou68 folds
sabre_laser folds
catimini56 checks
*** FLOP *** [3c 4s 9d]
catimini56 checks
jackymichell bets 1200
isc4rion raises 1200 to 2400
catimini56 folds
jackymichell calls 470 and is all-in
*** TURN *** [3c 4s 9d][6c]
*** RIVER *** [3c 4s 9d 6c][3s]
*** SHOW DOWN ***
jackymichell shows [Ks 9h] (Two pairs : 9 and 3)
isc4rion shows [9c Tc] (Two pairs : 9 and 3)
isc4rion collected 730 from side pot 1
jackymichell collected 4200 from main pot
*** SUMMARY ***
Total pot 4930 | No rake
Board: [3c 4s 9d 6c 3s]
Seat 1: isc4rion showed [9c Tc] and won 730 with Two pairs : 9 and 3
Seat 6: jackymichell showed [Ks 9h] and won 4200 with Two pairs : 9 and 3


Winamax Poker - Tournament "KING 5 - Stade 1C" buyIn: Ticket only level: 7 - HandId: #469971603749339263-59-1424808975 - Holdem no limit (20/100/200) - 2015/02/24 20:16:15 UTC
Table: 'KING 5 - Stade 1C(109423791)#126' 9-max (real money) Seat #3 is the button
Seat 1: isc4rion (1428)
Seat 2: didou68 (3275)
Seat 3: sabre_laser (1670)
Seat 4: catimini56 (7780)
Seat 5: Kephren25 (5990)
Seat 6: jackymichell (4200)
Seat 7: Matrix2607 (6610)
Seat 8: _NyX_ (3086)
Seat 9: Girlypok59 (9940)
*** ANTE/BLINDS ***
catimini56 posts ante 20
Kephren25 posts ante 20
isc4rion posts ante 20
didou68 posts ante 20
sabre_laser posts ante 20
jackymichell posts ante 20
Matrix2607 posts ante 20
_NyX_ posts ante 20
Girlypok59 posts ante 20
catimini56 posts small blind 100
Kephren25 posts big blind 200
Dealt to sabre_laser [Jc 9h]
*** PRE-FLOP *** 
jackymichell folds
Matrix2607 folds
_NyX_ raises 400 to 600
Girlypok59 calls 600
isc4rion folds
didou68 folds
sabre_laser folds
catimini56 folds
Kephren25 folds
*** FLOP *** [Kh 3h 4h]
_NyX_ checks
Girlypok59 checks
*** TURN *** [Kh 3h 4h][7c]
_NyX_ bets 1680
Girlypok59 folds
_NyX_ collected 3360 from pot
*** SUMMARY ***
Total pot 3360 | No rake
Board: [Kh 3h 4h 7c]
Seat 8: _NyX_ won 3360


Winamax Poker - Tournament "KING 5 - Stade 1C" buyIn: Ticket only level: 7 - HandId: #469971603749339263-60-1424809031 - Holdem no limit (20/100/200) - 2015/02/24 20:17:11 UTC
Table: 'KING 5 - Stade 1C(109423791)#126' 9-max (real money) Seat #4 is the button
Seat 1: isc4rion (1408)
Seat 2: didou68 (3255)
Seat 3: sabre_laser (1650)
Seat 4: catimini56 (7660)
Seat 5: Kephren25 (5770)
Seat 6: jackymichell (4180)
Seat 7: Matrix2607 (6590)
Seat 8: _NyX_ (4146)
Seat 9: Girlypok59 (9320)
*** ANTE/BLINDS ***
Kephren25 posts ante 20
jackymichell posts ante 20
isc4rion posts ante 20
didou68 posts ante 20
sabre_laser posts ante 20
catimini56 posts ante 20
Matrix2607 posts ante 20
_NyX_ posts ante 20
Girlypok59 posts ante 20
Kephren25 posts small blind 100
jackymichell posts big blind 200
Dealt to sabre_laser [Qc 4s]
*** PRE-FLOP *** 
Matrix2607 raises 400 to 600
_NyX_ folds
Girlypok59 raises 400 to 1000
isc4rion folds
didou68 folds
sabre_laser folds
catimini56 folds
Kephren25 folds
jackymichell folds
Matrix2607 calls 400
*** FLOP *** [5c Th Qd]
Matrix2607 bets 828
Girlypok59 calls 828
*** TURN *** [5c Th Qd][9c]
Matrix2607 bets 1099
Girlypok59 calls 1099
*** RIVER *** [5c Th Qd 9c][Qh]
Matrix2607 bets 1291
Girlypok59 calls 1291
*** SHOW DOWN ***
Girlypok59 shows [Ac Kc] (One pair : Queens)
Matrix2607 shows [Jh Jc] (Two pairs : Queens and Jacks)
Matrix2607 collected 8916 from pot
*** SUMMARY ***
Total pot 8916 | No rake
Board: [5c Th Qd 9c Qh]
Seat 7: Matrix2607 showed [Jh Jc] and won 8916 with Two pairs : Queens and Jacks
Seat 9: Girlypok59 showed [Ac Kc] and lost with One pair : Queens


Winamax Poker - Tournament "KING 5 - Stade 1C" buyIn: Ticket only level: 7 - HandId: #469971603749339263-61-1424809127 - Holdem no limit (20/100/200) - 2015/02/24 20:18:47 UTC
Table: 'KING 5 - Stade 1C(109423791)#126' 9-max (real money) Seat #5 is the button
Seat 1: isc4rion (1388)
Seat 2: didou68 (3235)
Seat 3: sabre_laser (1630)
Seat 4: catimini56 (7640)
Seat 5: Kephren25 (5650)
Seat 6: jackymichell (3960)
Seat 7: Matrix2607 (11268)
Seat 8: _NyX_ (4126)
Seat 9: Girlypok59 (5082)
*** ANTE/BLINDS ***
jackymichell posts ante 20
Matrix2607 posts ante 20
isc4rion posts ante 20
didou68 posts ante 20
sabre_laser posts ante 20
catimini56 posts ante 20
Kephren25 posts ante 20
_NyX_ posts ante 20
Girlypok59 posts ante 20
jackymichell posts small blind 100
Matrix2607 posts big blind 200
Dealt to sabre_laser [Kc 9c]
*** PRE-FLOP *** 
_NyX_ folds
Girlypok59 calls 200
isc4rion folds
didou68 folds
sabre_laser folds
catimini56 folds
Kephren25 folds
jackymichell calls 100
Matrix2607 checks
*** FLOP *** [Ks Ac 2d]
jackymichell checks
Matrix2607 checks
Girlypok59 bets 200
jackymichell folds
Matrix2607 calls 200
*** TURN *** [Ks Ac 2d][Qc]
Matrix2607 checks
Girlypok59 checks
*** RIVER *** [Ks Ac 2d Qc][2h]
Matrix2607 bets 700
Girlypok59 folds
Matrix2607 collected 1880 from pot
*** SUMMARY ***
Total pot 1880 | No rake
Board: [Ks Ac 2d Qc 2h]
Seat 7: Matrix2607 (big blind) won 1880


Winamax Poker - Tournament "KING 5 - Stade 1C" buyIn: Ticket only level: 8 - HandId: #469971603749339263-62-1424809224 - Holdem no limit (25/125/250) - 2015/02/24 20:20:24 UTC
Table: 'KING 5 - Stade 1C(109423791)#126' 9-max (real money) Seat #6 is the button
Seat 1: isc4rion (1368)
Seat 2: didou68 (3215)
Seat 3: sabre_laser (1610)
Seat 4: catimini56 (7620)
Seat 5: Kephren25 (5630)
Seat 6: jackymichell (3740)
Seat 7: Matrix2607 (12028)
Seat 8: _NyX_ (4106)
Seat 9: Girlypok59 (4662)
*** ANTE/BLINDS ***
Matrix2607 posts ante 25
_NyX_ posts ante 25
isc4rion posts ante 25
didou68 posts ante 25
sabre_laser posts ante 25
catimini56 posts ante 25
Kephren25 posts ante 25
jackymichell posts ante 25
Girlypok59 posts ante 25
Matrix2607 posts small blind 125
_NyX_ posts big blind 250
Dealt to sabre_laser [6d 6s]
*** PRE-FLOP *** 
Girlypok59 folds
isc4rion folds
didou68 raises 360 to 610
sabre_laser folds
catimini56 folds
Kephren25 folds
jackymichell folds
Matrix2607 folds
_NyX_ calls 360
*** FLOP *** [2d 5s 9d]
_NyX_ checks
didou68 bets 810
_NyX_ calls 810
*** TURN *** [2d 5s 9d][7c]
_NyX_ bets 1875
didou68 folds
_NyX_ collected 5065 from pot
*** SUMMARY ***
Total pot 5065 | No rake
Board: [2d 5s 9d 7c]
Seat 8: _NyX_ (big blind) won 5065


Winamax Poker - Tournament "KING 5 - Stade 1C" buyIn: Ticket only level: 8 - HandId: #469971603749339263-63-1424809312 - Holdem no limit (25/125/250) - 2015/02/24 20:21:52 UTC
Table: 'KING 5 - Stade 1C(109423791)#126' 9-max (real money) Seat #7 is the button
Seat 1: isc4rion (1343)
Seat 2: didou68 (1770)
Seat 3: sabre_laser (1585)
Seat 4: catimini56 (7595)
Seat 5: Kephren25 (5605)
Seat 6: jackymichell (3715)
Seat 7: Matrix2607 (11878)
Seat 8: _NyX_ (5851)
Seat 9: Girlypok59 (4637)
*** ANTE/BLINDS ***
_NyX_ posts ante 25
Girlypok59 posts ante 25
isc4rion posts ante 25
didou68 posts ante 25
sabre_laser posts ante 25
catimini56 posts ante 25
Kephren25 posts ante 25
jackymichell posts ante 25
Matrix2607 posts ante 25
_NyX_ posts small blind 125
Girlypok59 posts big blind 250
Dealt to sabre_laser [Ks 6h]
*** PRE-FLOP *** 
isc4rion folds
didou68 raises 1495 to 1745 and is all-in
sabre_laser folds
catimini56 folds
Kephren25 folds
jackymichell folds
Matrix2607 folds
_NyX_ folds
Girlypok59 calls 1495
*** FLOP *** [Kd 7h 9h]
*** TURN *** [Kd 7h 9h][3c]
*** RIVER *** [Kd 7h 9h 3c][5c]
*** SHOW DOWN ***
Girlypok59 shows [Qd Ac] (High card : Ace)
didou68 shows [4s 4d] (One pair : 4)
didou68 collected 3840 from pot
*** SUMMARY ***
Total pot 3840 | No rake
Board: [Kd 7h 9h 3c 5c]
Seat 2: didou68 showed [4s 4d] and won 3840 with One pair : 4
Seat 9: Girlypok59 (big blind) showed [Qd Ac] and lost with High card : Ace


Winamax Poker - Tournament "KING 5 - Stade 1C" buyIn: Ticket only level: 8 - HandId: #469971603749339263-64-1424809350 - Holdem no limit (25/125/250) - 2015/02/24 20:22:30 UTC
Table: 'KING 5 - Stade 1C(109423791)#126' 9-max (real money) Seat #8 is the button
Seat 1: isc4rion (1318)
Seat 2: didou68 (3840)
Seat 3: sabre_laser (1560)
Seat 4: catimini56 (7570)
Seat 5: Kephren25 (5580)
Seat 6: jackymichell (3690)
Seat 7: Matrix2607 (11853)
Seat 8: _NyX_ (5701)
Seat 9: Girlypok59 (2867)
*** ANTE/BLINDS ***
Girlypok59 posts ante 25
isc4rion posts ante 25
didou68 posts ante 25
sabre_laser posts ante 25
catimini56 posts ante 25
Kephren25 posts ante 25
jackymichell posts ante 25
Matrix2607 posts ante 25
_NyX_ posts ante 25
Girlypok59 posts small blind 125
isc4rion posts big blind 250
Dealt to sabre_laser [Qd 7h]
*** PRE-FLOP *** 
didou68 folds
sabre_laser folds
catimini56 folds
Kephren25 folds
jackymichell folds
Matrix2607 folds
_NyX_ calls 250
Girlypok59 folds
isc4rion checks
*** FLOP *** [8h Qs Th]
isc4rion checks
_NyX_ bets 850
isc4rion raises 193 to 1043 and is all-in
_NyX_ calls 193
*** TURN *** [8h Qs Th][Ad]
*** RIVER *** [8h Qs Th Ad][Jc]
*** SHOW DOWN ***
isc4rion shows [7s Qc] (One pair : Queens)
_NyX_ shows [Qh Kd] (Straight Ace high)
_NyX_ collected 2936 from pot
*** SUMMARY ***
Total pot 2936 | No rake
Board: [8h Qs Th Ad Jc]
Seat 1: isc4rion (big blind) showed [7s Qc] and lost with One pair : Queens
Seat 8: _NyX_ (button) showed [Qh Kd] and won 2936 with Straight Ace high


Winamax Poker - Tournament "KING 5 - Stade 1C" buyIn: Ticket only level: 8 - HandId: #469971603749339263-65-1424809436 - Holdem no limit (25/125/250) - 2015/02/24 20:23:56 UTC
Table: 'KING 5 - Stade 1C(109423791)#126' 9-max (real money) Seat #9 is the button
Seat 2: didou68 (3815)
Seat 3: sabre_laser (1535)
Seat 4: catimini56 (7545)
Seat 5: Kephren25 (5555)
Seat 6: jackymichell (3665)
Seat 7: Matrix2607 (11828)
Seat 8: _NyX_ (7319)
Seat 9: Girlypok59 (2717)
*** ANTE/BLINDS ***
didou68 posts ante 25
sabre_laser posts ante 25
catimini56 posts ante 25
Kephren25 posts ante 25
jackymichell posts ante 25
Matrix2607 posts ante 25
_NyX_ posts ante 25
Girlypok59 posts ante 25
didou68 posts big blind 250
Dealt to sabre_laser [5d Ad]
*** PRE-FLOP *** 
sabre_laser folds
catimini56 folds
Kephren25 folds
jackymichell raises 500 to 750
Matrix2607 folds
_NyX_ folds
Girlypok59 folds
didou68 folds
jackymichell collected 1200 from pot
*** SUMMARY ***
Total pot 1200 | No rake
Seat 6: jackymichell won 1200


Winamax Poker - Tournament "KING 5 - Stade 1C" buyIn: Ticket only level: 8 - HandId: #469971603749339263-66-1424809502 - Holdem no limit (25/125/250) - 2015/02/24 20:25:02 UTC
Table: 'KING 5 - Stade 1C(109423791)#126' 9-max (real money) Seat #1 is the button
Seat 1: Jeep73 (2970)
Seat 2: didou68 (3540)
Seat 3: sabre_laser (1510)
Seat 4: catimini56 (7520)
Seat 5: Kephren25 (5530)
Seat 6: jackymichell (4090)
Seat 7: Matrix2607 (11803)
Seat 8: _NyX_ (7294)
Seat 9: Girlypok59 (2692)
*** ANTE/BLINDS ***
didou68 posts ante 25
sabre_laser posts ante 25
catimini56 posts ante 25
Kephren25 posts ante 25
jackymichell posts ante 25
Matrix2607 posts ante 25
_NyX_ posts ante 25
Girlypok59 posts ante 25
didou68 posts small blind 125
sabre_laser posts big blind 250
Dealt to sabre_laser [8c Qs]
*** PRE-FLOP *** 
catimini56 folds
Kephren25 folds
jackymichell folds
Matrix2607 folds
_NyX_ folds
Girlypok59 calls 250
didou68 raises 3265 to 3515 and is all-in
sabre_laser folds
Girlypok59 folds
didou68 collected 4215 from pot
*** SUMMARY ***
Total pot 4215 | No rake
Seat 2: didou68 (small blind) won 4215


Winamax Poker - Tournament "KING 5 - Stade 1C" buyIn: Ticket only level: 8 - HandId: #469971603749339263-67-1424809560 - Holdem no limit (25/125/250) - 2015/02/24 20:26:00 UTC
Table: 'KING 5 - Stade 1C(109423791)#126' 9-max (real money) Seat #2 is the button
Seat 1: Jeep73 (2970)
Seat 2: didou68 (4215)
Seat 3: sabre_laser (1235)
Seat 4: catimini56 (7495)
Seat 5: Kephren25 (5505)
Seat 6: jackymichell (4065)
Seat 7: Matrix2607 (11778)
Seat 8: _NyX_ (7269)
Seat 9: Girlypok59 (2417)
*** ANTE/BLINDS ***
sabre_laser posts ante 25
catimini56 posts ante 25
Jeep73 posts ante 25
didou68 posts ante 25
Kephren25 posts ante 25
jackymichell posts ante 25
Matrix2607 posts ante 25
_NyX_ posts ante 25
Girlypok59 posts ante 25
sabre_laser posts small blind 125
catimini56 posts big blind 250
Dealt to sabre_laser [3c 9h]
*** PRE-FLOP *** 
Kephren25 folds
jackymichell folds
Matrix2607 folds
_NyX_ folds
Girlypok59 folds
Jeep73 folds
didou68 folds
sabre_laser folds
catimini56 collected 600 from pot
*** SUMMARY ***
Total pot 600 | No rake
Seat 4: catimini56 (big blind) won 600


Winamax Poker - Tournament "KING 5 - Stade 1C" buyIn: Ticket only level: 8 - HandId: #469971603749339263-68-1424809609 - Holdem no limit (25/125/250) - 2015/02/24 20:26:49 UTC
Table: 'KING 5 - Stade 1C(109423791)#126' 9-max (real money) Seat #3 is the button
Seat 1: Jeep73 (2945)
Seat 2: didou68 (4190)
Seat 3: sabre_laser (1085)
Seat 4: catimini56 (7820)
Seat 5: Kephren25 (5480)
Seat 6: jackymichell (4040)
Seat 7: Matrix2607 (11753)
Seat 8: _NyX_ (7244)
Seat 9: Girlypok59 (2392)
*** ANTE/BLINDS ***
catimini56 posts ante 25
Kephren25 posts ante 25
Jeep73 posts ante 25
didou68 posts ante 25
sabre_laser posts ante 25
jackymichell posts ante 25
Matrix2607 posts ante 25
_NyX_ posts ante 25
Girlypok59 posts ante 25
catimini56 posts small blind 125
Kephren25 posts big blind 250
Dealt to sabre_laser [2c Jc]
*** PRE-FLOP *** 
jackymichell raises 375 to 625
Matrix2607 folds
_NyX_ folds
Girlypok59 folds
Jeep73 folds
didou68 folds
sabre_laser folds
catimini56 folds
Kephren25 raises 4830 to 5455 and is all-in
jackymichell folds
Kephren25 collected 6430 from pot
*** SUMMARY ***
Total pot 6430 | No rake
Seat 5: Kephren25 (big blind) won 6430


Winamax Poker - Tournament "KING 5 - Stade 1C" buyIn: Ticket only level: 9 - HandId: #469971603749339263-69-1424809675 - Holdem no limit (35/150/300) - 2015/02/24 20:27:55 UTC
Table: 'KING 5 - Stade 1C(109423791)#126' 9-max (real money) Seat #4 is the button
Seat 1: Jeep73 (2920)
Seat 2: didou68 (4165)
Seat 3: sabre_laser (1060)
Seat 4: catimini56 (7670)
Seat 5: Kephren25 (6430)
Seat 6: jackymichell (3390)
Seat 7: Matrix2607 (11728)
Seat 8: _NyX_ (7219)
Seat 9: Girlypok59 (2367)
*** ANTE/BLINDS ***
Kephren25 posts ante 35
jackymichell posts ante 35
Jeep73 posts ante 35
didou68 posts ante 35
sabre_laser posts ante 35
catimini56 posts ante 35
Matrix2607 posts ante 35
_NyX_ posts ante 35
Girlypok59 posts ante 35
Kephren25 posts small blind 150
jackymichell posts big blind 300
Dealt to sabre_laser [6s 6h]
*** PRE-FLOP *** 
Matrix2607 folds
_NyX_ folds
Girlypok59 raises 300 to 600
Jeep73 folds
didou68 folds
sabre_laser raises 425 to 1025 and is all-in
catimini56 folds
Kephren25 folds
jackymichell folds
Girlypok59 calls 425
*** FLOP *** [Ts 3h 4s]
*** TURN *** [Ts 3h 4s][9h]
*** RIVER *** [Ts 3h 4s 9h][Qh]
*** SHOW DOWN ***
sabre_laser shows [6s 6h] (One pair : 6)
Girlypok59 shows [Ks Qc] (One pair : Queens)
Girlypok59 collected 2815 from pot
*** SUMMARY ***
Total pot 2815 | No rake
Board: [Ts 3h 4s 9h Qh]
Seat 3: sabre_laser showed [6s 6h] and lost with One pair : 6
Seat 9: Girlypok59 showed [Ks Qc] and won 2815 with One pair : Queens


