Winamax Poker - Tournament "Double or Nothing" buyIn: 0,46€ + 0,04€ level: 0 - HandId: #540640428702040065-1-1438023696 - Holdem no limit (10/20) - 2015/07/27 19:01:36 UTC
Table: 'Double or Nothing(125877659)#0' 10-max (real money) Seat #5 is the button
Seat 1: Crisssis (1500)
Seat 2: bisounours25 (1500)
Seat 3: _SmAuG_rAiSe (1500)
Seat 4: sabre_laser (1500)
Seat 5: Maxwell50110 (1500)
Seat 6: Rythie63 (1500)
Seat 7: Margeurite (1500)
Seat 8: raoulbourvil (1500)
Seat 9: beto3131 (1500)
Seat 10: SoMn5mn5 (1500)
*** ANTE/BLINDS ***
Rythie63 posts small blind 10
Margeurite posts big blind 20
Dealt to sabre_laser [6s 9h]
*** PRE-FLOP *** 
raoulbourvil folds
beto3131 calls 20
SoMn5mn5 folds
Crisssis folds
bisounours25 folds
_SmAuG_rAiSe folds
sabre_laser folds
Maxwell50110 folds
Rythie63 raises 20 to 40
Margeurite calls 20
beto3131 calls 20
*** FLOP *** [8d 5s 3h]
Rythie63 bets 80
Margeurite folds
beto3131 folds
Rythie63 collected 200 from pot
*** SUMMARY ***
Total pot 200 | No rake
Board: [8d 5s 3h]
Seat 6: Rythie63 (small blind) won 200


Winamax Poker - Tournament "Double or Nothing" buyIn: 0,46€ + 0,04€ level: 0 - HandId: #540640428702040065-2-1438023760 - Holdem no limit (10/20) - 2015/07/27 19:02:40 UTC
Table: 'Double or Nothing(125877659)#0' 10-max (real money) Seat #6 is the button
Seat 1: Crisssis (1500)
Seat 2: bisounours25 (1500)
Seat 3: _SmAuG_rAiSe (1500)
Seat 4: sabre_laser (1500)
Seat 5: Maxwell50110 (1500)
Seat 6: Rythie63 (1580)
Seat 7: Margeurite (1460)
Seat 8: raoulbourvil (1500)
Seat 9: beto3131 (1460)
Seat 10: SoMn5mn5 (1500)
*** ANTE/BLINDS ***
Margeurite posts small blind 10
raoulbourvil posts big blind 20
Dealt to sabre_laser [8h 5s]
*** PRE-FLOP *** 
beto3131 folds
SoMn5mn5 folds
Crisssis folds
bisounours25 folds
_SmAuG_rAiSe folds
sabre_laser folds
Maxwell50110 folds
Rythie63 raises 130 to 150
Margeurite folds
raoulbourvil folds
Rythie63 collected 180 from pot
*** SUMMARY ***
Total pot 180 | No rake
Seat 6: Rythie63 (button) won 180


Winamax Poker - Tournament "Double or Nothing" buyIn: 0,46€ + 0,04€ level: 0 - HandId: #540640428702040065-3-1438023795 - Holdem no limit (10/20) - 2015/07/27 19:03:15 UTC
Table: 'Double or Nothing(125877659)#0' 10-max (real money) Seat #7 is the button
Seat 1: Crisssis (1500)
Seat 2: bisounours25 (1500)
Seat 3: _SmAuG_rAiSe (1500)
Seat 4: sabre_laser (1500)
Seat 5: Maxwell50110 (1500)
Seat 6: Rythie63 (1610)
Seat 7: Margeurite (1450)
Seat 8: raoulbourvil (1480)
Seat 9: beto3131 (1460)
Seat 10: SoMn5mn5 (1500)
*** ANTE/BLINDS ***
raoulbourvil posts small blind 10
beto3131 posts big blind 20
Dealt to sabre_laser [Tc 2d]
*** PRE-FLOP *** 
SoMn5mn5 folds
Crisssis folds
bisounours25 folds
_SmAuG_rAiSe folds
sabre_laser folds
Maxwell50110 folds
Rythie63 raises 60 to 80
Margeurite folds
raoulbourvil calls 70
beto3131 calls 60
*** FLOP *** [Td 6c 8d]
raoulbourvil checks
beto3131 checks
Rythie63 checks
*** TURN *** [Td 6c 8d][Th]
raoulbourvil checks
beto3131 checks
Rythie63 checks
*** RIVER *** [Td 6c 8d Th][6d]
raoulbourvil checks
beto3131 checks
Rythie63 checks
*** SHOW DOWN ***
Rythie63 shows [Jd Qs] (Two pairs : Tens and 6)
raoulbourvil shows [Ks 9c] (Two pairs : Tens and 6)
beto3131 shows [9h Kd] (Two pairs : Tens and 6)
beto3131 collected 120 from pot
raoulbourvil collected 120 from pot
*** SUMMARY ***
Total pot 240 | No rake
Board: [Td 6c 8d Th 6d]
Seat 6: Rythie63 showed [Jd Qs] and lost with Two pairs : Tens and 6
Seat 8: raoulbourvil (small blind) showed [Ks 9c] and won 120 with Two pairs : Tens and 6
Seat 9: beto3131 (big blind) showed [9h Kd] and won 120 with Two pairs : Tens and 6


Winamax Poker - Tournament "Double or Nothing" buyIn: 0,46€ + 0,04€ level: 0 - HandId: #540640428702040065-4-1438023848 - Holdem no limit (10/20) - 2015/07/27 19:04:08 UTC
Table: 'Double or Nothing(125877659)#0' 10-max (real money) Seat #8 is the button
Seat 1: Crisssis (1500)
Seat 2: bisounours25 (1500)
Seat 3: _SmAuG_rAiSe (1500)
Seat 4: sabre_laser (1500)
Seat 5: Maxwell50110 (1500)
Seat 6: Rythie63 (1530)
Seat 7: Margeurite (1450)
Seat 8: raoulbourvil (1520)
Seat 9: beto3131 (1500)
Seat 10: SoMn5mn5 (1500)
*** ANTE/BLINDS ***
beto3131 posts small blind 10
SoMn5mn5 posts big blind 20
Dealt to sabre_laser [Js Kc]
*** PRE-FLOP *** 
Crisssis folds
bisounours25 folds
_SmAuG_rAiSe raises 30 to 50
sabre_laser folds
Maxwell50110 folds
Rythie63 calls 50
Margeurite folds
raoulbourvil folds
beto3131 folds
SoMn5mn5 folds
*** FLOP *** [4h 8d Ac]
_SmAuG_rAiSe bets 65
Rythie63 raises 260 to 325
_SmAuG_rAiSe folds
Rythie63 collected 520 from pot
*** SUMMARY ***
Total pot 520 | No rake
Board: [4h 8d Ac]
Seat 6: Rythie63 won 520


Winamax Poker - Tournament "Double or Nothing" buyIn: 0,46€ + 0,04€ level: 1 - HandId: #540640428702040065-5-1438023980 - Holdem no limit (15/30) - 2015/07/27 19:06:20 UTC
Table: 'Double or Nothing(125877659)#0' 10-max (real money) Seat #9 is the button
Seat 1: Crisssis (1500)
Seat 2: bisounours25 (1500)
Seat 3: _SmAuG_rAiSe (1385)
Seat 4: sabre_laser (1500)
Seat 5: Maxwell50110 (1500)
Seat 6: Rythie63 (1675)
Seat 7: Margeurite (1450)
Seat 8: raoulbourvil (1520)
Seat 9: beto3131 (1490)
Seat 10: SoMn5mn5 (1480)
*** ANTE/BLINDS ***
SoMn5mn5 posts small blind 15
Crisssis posts big blind 30
Dealt to sabre_laser [Qc Ad]
*** PRE-FLOP *** 
bisounours25 folds
_SmAuG_rAiSe folds
sabre_laser raises 45 to 75
Maxwell50110 folds
Rythie63 folds
Margeurite folds
raoulbourvil folds
beto3131 folds
SoMn5mn5 folds
Crisssis folds
sabre_laser collected 120 from pot
*** SUMMARY ***
Total pot 120 | No rake
Seat 4: sabre_laser won 120


Winamax Poker - Tournament "Double or Nothing" buyIn: 0,46€ + 0,04€ level: 1 - HandId: #540640428702040065-6-1438024030 - Holdem no limit (15/30) - 2015/07/27 19:07:10 UTC
Table: 'Double or Nothing(125877659)#0' 10-max (real money) Seat #10 is the button
Seat 1: Crisssis (1470)
Seat 2: bisounours25 (1500)
Seat 3: _SmAuG_rAiSe (1385)
Seat 4: sabre_laser (1545)
Seat 5: Maxwell50110 (1500)
Seat 6: Rythie63 (1675)
Seat 7: Margeurite (1450)
Seat 8: raoulbourvil (1520)
Seat 9: beto3131 (1490)
Seat 10: SoMn5mn5 (1465)
*** ANTE/BLINDS ***
Crisssis posts small blind 15
bisounours25 posts big blind 30
Dealt to sabre_laser [Jh 7c]
*** PRE-FLOP *** 
_SmAuG_rAiSe folds
sabre_laser folds
Maxwell50110 folds
Rythie63 raises 30 to 60
Margeurite raises 120 to 180
raoulbourvil folds
beto3131 folds
SoMn5mn5 folds
Crisssis folds
bisounours25 folds
Rythie63 calls 120
*** FLOP *** [2c 4s 4d]
Rythie63 checks
Margeurite checks
*** TURN *** [2c 4s 4d][Qs]
Rythie63 bets 270
Margeurite calls 270
*** RIVER *** [2c 4s 4d Qs][Ad]
Rythie63 checks
Margeurite checks
*** SHOW DOWN ***
Rythie63 shows [8h 8s] (Two pairs : 8 and 4)
Margeurite shows [Qd Jd] (Two pairs : Queens and 4)
Margeurite collected 945 from pot
*** SUMMARY ***
Total pot 945 | No rake
Board: [2c 4s 4d Qs Ad]
Seat 6: Rythie63 showed [8h 8s] and lost with Two pairs : 8 and 4
Seat 7: Margeurite showed [Qd Jd] and won 945 with Two pairs : Queens and 4


Winamax Poker - Tournament "Double or Nothing" buyIn: 0,46€ + 0,04€ level: 2 - HandId: #540640428702040065-7-1438024105 - Holdem no limit (20/40) - 2015/07/27 19:08:25 UTC
Table: 'Double or Nothing(125877659)#0' 10-max (real money) Seat #1 is the button
Seat 1: Crisssis (1455)
Seat 2: bisounours25 (1470)
Seat 3: _SmAuG_rAiSe (1385)
Seat 4: sabre_laser (1545)
Seat 5: Maxwell50110 (1500)
Seat 6: Rythie63 (1225)
Seat 7: Margeurite (1945)
Seat 8: raoulbourvil (1520)
Seat 9: beto3131 (1490)
Seat 10: SoMn5mn5 (1465)
*** ANTE/BLINDS ***
bisounours25 posts small blind 20
_SmAuG_rAiSe posts big blind 40
Dealt to sabre_laser [2h Tc]
*** PRE-FLOP *** 
sabre_laser folds
Maxwell50110 folds
Rythie63 folds
Margeurite folds
raoulbourvil folds
beto3131 calls 40
SoMn5mn5 folds
Crisssis folds
bisounours25 folds
_SmAuG_rAiSe checks
*** FLOP *** [Ac 5h 4s]
_SmAuG_rAiSe checks
beto3131 bets 40
_SmAuG_rAiSe calls 40
*** TURN *** [Ac 5h 4s][Qc]
_SmAuG_rAiSe bets 120
beto3131 folds
_SmAuG_rAiSe collected 300 from pot
*** SUMMARY ***
Total pot 300 | No rake
Board: [Ac 5h 4s Qc]
Seat 3: _SmAuG_rAiSe (big blind) won 300


Winamax Poker - Tournament "Double or Nothing" buyIn: 0,46€ + 0,04€ level: 2 - HandId: #540640428702040065-8-1438024230 - Holdem no limit (20/40) - 2015/07/27 19:10:30 UTC
Table: 'Double or Nothing(125877659)#0' 10-max (real money) Seat #2 is the button
Seat 1: Crisssis (1455)
Seat 2: bisounours25 (1450)
Seat 3: _SmAuG_rAiSe (1485)
Seat 4: sabre_laser (1545)
Seat 5: Maxwell50110 (1500)
Seat 6: Rythie63 (1225)
Seat 7: Margeurite (1945)
Seat 8: raoulbourvil (1520)
Seat 9: beto3131 (1410)
Seat 10: SoMn5mn5 (1465)
*** ANTE/BLINDS ***
_SmAuG_rAiSe posts small blind 20
sabre_laser posts big blind 40
Dealt to sabre_laser [6s 6c]
*** PRE-FLOP *** 
Maxwell50110 folds
Rythie63 calls 40
Margeurite calls 40
raoulbourvil folds
beto3131 calls 40
SoMn5mn5 folds
Crisssis folds
bisounours25 folds
_SmAuG_rAiSe calls 20
sabre_laser checks
*** FLOP *** [2d Jd 2s]
_SmAuG_rAiSe bets 175
sabre_laser folds
Rythie63 folds
Margeurite folds
beto3131 raises 175 to 350
_SmAuG_rAiSe folds
beto3131 collected 725 from pot
*** SUMMARY ***
Total pot 725 | No rake
Board: [2d Jd 2s]
Seat 9: beto3131 won 725


Winamax Poker - Tournament "Double or Nothing" buyIn: 0,46€ + 0,04€ level: 3 - HandId: #540640428702040065-9-1438024322 - Holdem no limit (30/60) - 2015/07/27 19:12:02 UTC
Table: 'Double or Nothing(125877659)#0' 10-max (real money) Seat #3 is the button
Seat 1: Crisssis (1455)
Seat 2: bisounours25 (1450)
Seat 3: _SmAuG_rAiSe (1270)
Seat 4: sabre_laser (1505)
Seat 5: Maxwell50110 (1500)
Seat 6: Rythie63 (1185)
Seat 7: Margeurite (1905)
Seat 8: raoulbourvil (1520)
Seat 9: beto3131 (1745)
Seat 10: SoMn5mn5 (1465)
*** ANTE/BLINDS ***
sabre_laser posts small blind 30
Maxwell50110 posts big blind 60
Dealt to sabre_laser [9c 5s]
*** PRE-FLOP *** 
Rythie63 raises 150 to 210
Margeurite folds
raoulbourvil folds
beto3131 folds
SoMn5mn5 folds
Crisssis folds
bisounours25 folds
_SmAuG_rAiSe folds
sabre_laser folds
Maxwell50110 folds
Rythie63 collected 300 from pot
*** SUMMARY ***
Total pot 300 | No rake
Seat 6: Rythie63 won 300


Winamax Poker - Tournament "Double or Nothing" buyIn: 0,46€ + 0,04€ level: 3 - HandId: #540640428702040065-10-1438024362 - Holdem no limit (30/60) - 2015/07/27 19:12:42 UTC
Table: 'Double or Nothing(125877659)#0' 10-max (real money) Seat #4 is the button
Seat 1: Crisssis (1455)
Seat 2: bisounours25 (1450)
Seat 3: _SmAuG_rAiSe (1270)
Seat 4: sabre_laser (1475)
Seat 5: Maxwell50110 (1440)
Seat 6: Rythie63 (1275)
Seat 7: Margeurite (1905)
Seat 8: raoulbourvil (1520)
Seat 9: beto3131 (1745)
Seat 10: SoMn5mn5 (1465)
*** ANTE/BLINDS ***
Maxwell50110 posts small blind 30
Rythie63 posts big blind 60
Dealt to sabre_laser [9s 8c]
*** PRE-FLOP *** 
Margeurite folds
raoulbourvil folds
beto3131 folds
SoMn5mn5 raises 60 to 120
Crisssis folds
bisounours25 folds
_SmAuG_rAiSe calls 120
sabre_laser folds
Maxwell50110 folds
Rythie63 raises 1155 to 1275 and is all-in
SoMn5mn5 raises 190 to 1465 and is all-in
_SmAuG_rAiSe folds
*** FLOP *** [7d Ad 3s]
*** TURN *** [7d Ad 3s][9h]
*** RIVER *** [7d Ad 3s 9h][6c]
*** SHOW DOWN ***
Rythie63 shows [As Qh] (One pair : Aces)
SoMn5mn5 shows [Ac Kd] (One pair : Aces)
SoMn5mn5 collected 2890 from pot
*** SUMMARY ***
Total pot 2890 | No rake
Board: [7d Ad 3s 9h 6c]
Seat 6: Rythie63 (big blind) showed [As Qh] and lost with One pair : Aces
Seat 10: SoMn5mn5 showed [Ac Kd] and won 2890 with One pair : Aces


Winamax Poker - Tournament "Double or Nothing" buyIn: 0,46€ + 0,04€ level: 4 - HandId: #540640428702040065-11-1438024426 - Holdem no limit (40/80) - 2015/07/27 19:13:46 UTC
Table: 'Double or Nothing(125877659)#0' 10-max (real money) Seat #5 is the button
Seat 1: Crisssis (1455)
Seat 2: bisounours25 (1450)
Seat 3: _SmAuG_rAiSe (1150)
Seat 4: sabre_laser (1475)
Seat 5: Maxwell50110 (1410)
Seat 7: Margeurite (1905)
Seat 8: raoulbourvil (1520)
Seat 9: beto3131 (1745)
Seat 10: SoMn5mn5 (2890)
*** ANTE/BLINDS ***
Margeurite posts big blind 80
Dealt to sabre_laser [Jc 5d]
*** PRE-FLOP *** 
raoulbourvil folds
beto3131 folds
SoMn5mn5 folds
Crisssis folds
bisounours25 folds
_SmAuG_rAiSe folds
sabre_laser folds
Maxwell50110 raises 160 to 240
Margeurite folds
Maxwell50110 collected 320 from pot
*** SUMMARY ***
Total pot 320 | No rake
Seat 5: Maxwell50110 (button) won 320


Winamax Poker - Tournament "Double or Nothing" buyIn: 0,46€ + 0,04€ level: 4 - HandId: #540640428702040065-12-1438024479 - Holdem no limit (40/80) - 2015/07/27 19:14:39 UTC
Table: 'Double or Nothing(125877659)#0' 10-max (real money) Seat #6 is the button
Seat 1: Crisssis (1455)
Seat 2: bisounours25 (1450)
Seat 3: _SmAuG_rAiSe (1150)
Seat 4: sabre_laser (1475)
Seat 5: Maxwell50110 (1490)
Seat 7: Margeurite (1825)
Seat 8: raoulbourvil (1520)
Seat 9: beto3131 (1745)
Seat 10: SoMn5mn5 (2890)
*** ANTE/BLINDS ***
Margeurite posts small blind 40
raoulbourvil posts big blind 80
Dealt to sabre_laser [8d 9h]
*** PRE-FLOP *** 
beto3131 folds
SoMn5mn5 folds
Crisssis folds
bisounours25 folds
_SmAuG_rAiSe folds
sabre_laser folds
Maxwell50110 folds
Margeurite folds
raoulbourvil collected 120 from pot
*** SUMMARY ***
Total pot 120 | No rake
Seat 8: raoulbourvil (big blind) won 120


Winamax Poker - Tournament "Double or Nothing" buyIn: 0,46€ + 0,04€ level: 4 - HandId: #540640428702040065-13-1438024489 - Holdem no limit (40/80) - 2015/07/27 19:14:49 UTC
Table: 'Double or Nothing(125877659)#0' 10-max (real money) Seat #7 is the button
Seat 1: Crisssis (1455)
Seat 2: bisounours25 (1450)
Seat 3: _SmAuG_rAiSe (1150)
Seat 4: sabre_laser (1475)
Seat 5: Maxwell50110 (1490)
Seat 7: Margeurite (1785)
Seat 8: raoulbourvil (1560)
Seat 9: beto3131 (1745)
Seat 10: SoMn5mn5 (2890)
*** ANTE/BLINDS ***
raoulbourvil posts small blind 40
beto3131 posts big blind 80
Dealt to sabre_laser [Jc Kc]
*** PRE-FLOP *** 
SoMn5mn5 folds
Crisssis folds
bisounours25 folds
_SmAuG_rAiSe folds
sabre_laser raises 80 to 160
Maxwell50110 folds
Margeurite folds
raoulbourvil folds
beto3131 folds
sabre_laser collected 280 from pot
*** SUMMARY ***
Total pot 280 | No rake
Seat 4: sabre_laser won 280


Winamax Poker - Tournament "Double or Nothing" buyIn: 0,46€ + 0,04€ level: 4 - HandId: #540640428702040065-14-1438024510 - Holdem no limit (40/80) - 2015/07/27 19:15:10 UTC
Table: 'Double or Nothing(125877659)#0' 10-max (real money) Seat #8 is the button
Seat 1: Crisssis (1455)
Seat 2: bisounours25 (1450)
Seat 3: _SmAuG_rAiSe (1150)
Seat 4: sabre_laser (1595)
Seat 5: Maxwell50110 (1490)
Seat 7: Margeurite (1785)
Seat 8: raoulbourvil (1520)
Seat 9: beto3131 (1665)
Seat 10: SoMn5mn5 (2890)
*** ANTE/BLINDS ***
beto3131 posts small blind 40
SoMn5mn5 posts big blind 80
Dealt to sabre_laser [Kd 8c]
*** PRE-FLOP *** 
Crisssis folds
bisounours25 calls 80
_SmAuG_rAiSe raises 120 to 200
sabre_laser folds
Maxwell50110 folds
Margeurite folds
raoulbourvil folds
beto3131 calls 160
SoMn5mn5 folds
bisounours25 folds
*** FLOP *** [2d Tc 3d]
beto3131 checks
_SmAuG_rAiSe bets 280
beto3131 calls 280
*** TURN *** [2d Tc 3d][4s]
beto3131 checks
_SmAuG_rAiSe bets 670 and is all-in
beto3131 calls 670
*** RIVER *** [2d Tc 3d 4s][Qs]
*** SHOW DOWN ***
beto3131 shows [Ac As] (One pair : Aces)
_SmAuG_rAiSe shows [Qd Qc] (Trips of Queens)
_SmAuG_rAiSe collected 2460 from pot
*** SUMMARY ***
Total pot 2460 | No rake
Board: [2d Tc 3d 4s Qs]
Seat 3: _SmAuG_rAiSe showed [Qd Qc] and won 2460 with Trips of Queens
Seat 9: beto3131 (small blind) showed [Ac As] and lost with One pair : Aces


Winamax Poker - Tournament "Double or Nothing" buyIn: 0,46€ + 0,04€ level: 5 - HandId: #540640428702040065-15-1438024596 - Holdem no limit (60/120) - 2015/07/27 19:16:36 UTC
Table: 'Double or Nothing(125877659)#0' 10-max (real money) Seat #9 is the button
Seat 1: Crisssis (1455)
Seat 2: bisounours25 (1370)
Seat 3: _SmAuG_rAiSe (2460)
Seat 4: sabre_laser (1595)
Seat 5: Maxwell50110 (1490)
Seat 7: Margeurite (1785)
Seat 8: raoulbourvil (1520)
Seat 9: beto3131 (515)
Seat 10: SoMn5mn5 (2810)
*** ANTE/BLINDS ***
SoMn5mn5 posts small blind 60
Crisssis posts big blind 120
Dealt to sabre_laser [2h 5h]
*** PRE-FLOP *** 
bisounours25 folds
_SmAuG_rAiSe folds
sabre_laser folds
Maxwell50110 folds
Margeurite folds
raoulbourvil folds
beto3131 raises 120 to 240
SoMn5mn5 folds
Crisssis folds
beto3131 collected 420 from pot
*** SUMMARY ***
Total pot 420 | No rake
Seat 9: beto3131 (button) won 420


Winamax Poker - Tournament "Double or Nothing" buyIn: 0,46€ + 0,04€ level: 5 - HandId: #540640428702040065-16-1438024658 - Holdem no limit (60/120) - 2015/07/27 19:17:38 UTC
Table: 'Double or Nothing(125877659)#0' 10-max (real money) Seat #10 is the button
Seat 1: Crisssis (1335)
Seat 2: bisounours25 (1370)
Seat 3: _SmAuG_rAiSe (2460)
Seat 4: sabre_laser (1595)
Seat 5: Maxwell50110 (1490)
Seat 7: Margeurite (1785)
Seat 8: raoulbourvil (1520)
Seat 9: beto3131 (695)
Seat 10: SoMn5mn5 (2750)
*** ANTE/BLINDS ***
Crisssis posts small blind 60
bisounours25 posts big blind 120
Dealt to sabre_laser [Tc 8d]
*** PRE-FLOP *** 
_SmAuG_rAiSe folds
sabre_laser folds
Maxwell50110 folds
Margeurite folds
raoulbourvil folds
beto3131 folds
SoMn5mn5 folds
Crisssis raises 180 to 300
bisounours25 folds
Crisssis collected 420 from pot
*** SUMMARY ***
Total pot 420 | No rake
Seat 1: Crisssis (small blind) won 420


Winamax Poker - Tournament "Double or Nothing" buyIn: 0,46€ + 0,04€ level: 5 - HandId: #540640428702040065-17-1438024680 - Holdem no limit (60/120) - 2015/07/27 19:18:00 UTC
Table: 'Double or Nothing(125877659)#0' 10-max (real money) Seat #1 is the button
Seat 1: Crisssis (1455)
Seat 2: bisounours25 (1250)
Seat 3: _SmAuG_rAiSe (2460)
Seat 4: sabre_laser (1595)
Seat 5: Maxwell50110 (1490)
Seat 7: Margeurite (1785)
Seat 8: raoulbourvil (1520)
Seat 9: beto3131 (695)
Seat 10: SoMn5mn5 (2750)
*** ANTE/BLINDS ***
bisounours25 posts small blind 60
_SmAuG_rAiSe posts big blind 120
Dealt to sabre_laser [5d 4s]
*** PRE-FLOP *** 
sabre_laser folds
Maxwell50110 folds
Margeurite folds
raoulbourvil folds
beto3131 raises 575 to 695 and is all-in
SoMn5mn5 folds
Crisssis folds
bisounours25 folds
_SmAuG_rAiSe folds
beto3131 collected 875 from pot
*** SUMMARY ***
Total pot 875 | No rake
Seat 9: beto3131 won 875


Winamax Poker - Tournament "Double or Nothing" buyIn: 0,46€ + 0,04€ level: 5 - HandId: #540640428702040065-18-1438024727 - Holdem no limit (60/120) - 2015/07/27 19:18:47 UTC
Table: 'Double or Nothing(125877659)#0' 10-max (real money) Seat #2 is the button
Seat 1: Crisssis (1455)
Seat 2: bisounours25 (1190)
Seat 3: _SmAuG_rAiSe (2340)
Seat 4: sabre_laser (1595)
Seat 5: Maxwell50110 (1490)
Seat 7: Margeurite (1785)
Seat 8: raoulbourvil (1520)
Seat 9: beto3131 (875)
Seat 10: SoMn5mn5 (2750)
*** ANTE/BLINDS ***
_SmAuG_rAiSe posts small blind 60
sabre_laser posts big blind 120
Dealt to sabre_laser [Ts Qc]
*** PRE-FLOP *** 
Maxwell50110 raises 240 to 360
Margeurite folds
raoulbourvil folds
beto3131 folds
SoMn5mn5 folds
Crisssis folds
bisounours25 folds
_SmAuG_rAiSe folds
sabre_laser folds
Maxwell50110 collected 540 from pot
*** SUMMARY ***
Total pot 540 | No rake
Seat 5: Maxwell50110 won 540


Winamax Poker - Tournament "Double or Nothing" buyIn: 0,46€ + 0,04€ level: 6 - HandId: #540640428702040065-19-1438024774 - Holdem no limit (80/160) - 2015/07/27 19:19:34 UTC
Table: 'Double or Nothing(125877659)#0' 10-max (real money) Seat #3 is the button
Seat 1: Crisssis (1455)
Seat 2: bisounours25 (1190)
Seat 3: _SmAuG_rAiSe (2280)
Seat 4: sabre_laser (1475)
Seat 5: Maxwell50110 (1670)
Seat 7: Margeurite (1785)
Seat 8: raoulbourvil (1520)
Seat 9: beto3131 (875)
Seat 10: SoMn5mn5 (2750)
*** ANTE/BLINDS ***
sabre_laser posts small blind 80
Maxwell50110 posts big blind 160
Dealt to sabre_laser [5c Ah]
*** PRE-FLOP *** 
Margeurite folds
raoulbourvil folds
beto3131 folds
SoMn5mn5 folds
Crisssis folds
bisounours25 folds
_SmAuG_rAiSe raises 160 to 320
sabre_laser folds
Maxwell50110 folds
_SmAuG_rAiSe collected 560 from pot
*** SUMMARY ***
Total pot 560 | No rake
Seat 3: _SmAuG_rAiSe (button) won 560


Winamax Poker - Tournament "Double or Nothing" buyIn: 0,46€ + 0,04€ level: 6 - HandId: #540640428702040065-20-1438024829 - Holdem no limit (80/160) - 2015/07/27 19:20:29 UTC
Table: 'Double or Nothing(125877659)#0' 10-max (real money) Seat #4 is the button
Seat 1: Crisssis (1455)
Seat 2: bisounours25 (1190)
Seat 3: _SmAuG_rAiSe (2520)
Seat 4: sabre_laser (1395)
Seat 5: Maxwell50110 (1510)
Seat 7: Margeurite (1785)
Seat 8: raoulbourvil (1520)
Seat 9: beto3131 (875)
Seat 10: SoMn5mn5 (2750)
*** ANTE/BLINDS ***
Maxwell50110 posts small blind 80
Margeurite posts big blind 160
Dealt to sabre_laser [4s 2d]
*** PRE-FLOP *** 
raoulbourvil folds
beto3131 folds
SoMn5mn5 folds
Crisssis folds
bisounours25 folds
_SmAuG_rAiSe calls 160
sabre_laser folds
Maxwell50110 folds
Margeurite checks
*** FLOP *** [9d As Ac]
Margeurite checks
_SmAuG_rAiSe checks
*** TURN *** [9d As Ac][6s]
Margeurite checks
_SmAuG_rAiSe checks
*** RIVER *** [9d As Ac 6s][Kd]
Margeurite checks
_SmAuG_rAiSe checks
*** SHOW DOWN ***
Margeurite shows [8d Ts] (One pair : Aces)
_SmAuG_rAiSe shows [Qd Jc] (One pair : Aces)
_SmAuG_rAiSe collected 400 from pot
*** SUMMARY ***
Total pot 400 | No rake
Board: [9d As Ac 6s Kd]
Seat 3: _SmAuG_rAiSe showed [Qd Jc] and won 400 with One pair : Aces
Seat 7: Margeurite (big blind) showed [8d Ts] and lost with One pair : Aces


Winamax Poker - Tournament "Double or Nothing" buyIn: 0,46€ + 0,04€ level: 6 - HandId: #540640428702040065-21-1438024904 - Holdem no limit (80/160) - 2015/07/27 19:21:44 UTC
Table: 'Double or Nothing(125877659)#0' 10-max (real money) Seat #5 is the button
Seat 1: Crisssis (1455)
Seat 2: bisounours25 (1190)
Seat 3: _SmAuG_rAiSe (2760)
Seat 4: sabre_laser (1395)
Seat 5: Maxwell50110 (1430)
Seat 7: Margeurite (1625)
Seat 8: raoulbourvil (1520)
Seat 9: beto3131 (875)
Seat 10: SoMn5mn5 (2750)
*** ANTE/BLINDS ***
Margeurite posts small blind 80
raoulbourvil posts big blind 160
Dealt to sabre_laser [Qc Jd]
*** PRE-FLOP *** 
beto3131 raises 710 to 870
SoMn5mn5 folds
Crisssis folds
bisounours25 calls 870
_SmAuG_rAiSe folds
sabre_laser folds
Maxwell50110 folds
Margeurite folds
raoulbourvil folds
*** FLOP *** [9c Ah 5c]
beto3131 bets 5 and is all-in
bisounours25 calls 5
*** TURN *** [9c Ah 5c][Ac]
*** RIVER *** [9c Ah 5c Ac][2h]
*** SHOW DOWN ***
beto3131 shows [9s Js] (Two pairs : Aces and 9)
bisounours25 shows [As Ad] (Quads of Aces)
bisounours25 collected 1990 from pot
*** SUMMARY ***
Total pot 1990 | No rake
Board: [9c Ah 5c Ac 2h]
Seat 2: bisounours25 showed [As Ad] and won 1990 with Quads of Aces
Seat 9: beto3131 showed [9s Js] and lost with Two pairs : Aces and 9


Winamax Poker - Tournament "Double or Nothing" buyIn: 0,46€ + 0,04€ level: 6 - HandId: #540640428702040065-22-1438024951 - Holdem no limit (80/160) - 2015/07/27 19:22:31 UTC
Table: 'Double or Nothing(125877659)#0' 10-max (real money) Seat #7 is the button
Seat 1: Crisssis (1455)
Seat 2: bisounours25 (2305)
Seat 3: _SmAuG_rAiSe (2760)
Seat 4: sabre_laser (1395)
Seat 5: Maxwell50110 (1430)
Seat 7: Margeurite (1545)
Seat 8: raoulbourvil (1360)
Seat 10: SoMn5mn5 (2750)
*** ANTE/BLINDS ***
raoulbourvil posts small blind 80
SoMn5mn5 posts big blind 160
Dealt to sabre_laser [Js Ts]
*** PRE-FLOP *** 
Crisssis folds
bisounours25 folds
_SmAuG_rAiSe folds
sabre_laser calls 160
Maxwell50110 folds
Margeurite folds
raoulbourvil folds
SoMn5mn5 checks
*** FLOP *** [Jc 5d Qs]
SoMn5mn5 checks
sabre_laser bets 300
SoMn5mn5 folds
sabre_laser collected 700 from pot
*** SUMMARY ***
Total pot 700 | No rake
Board: [Jc 5d Qs]
Seat 4: sabre_laser won 700


Winamax Poker - Tournament "Double or Nothing" buyIn: 0,46€ + 0,04€ level: 7 - HandId: #540640428702040065-23-1438025002 - Holdem no limit (10/100/200) - 2015/07/27 19:23:22 UTC
Table: 'Double or Nothing(125877659)#0' 10-max (real money) Seat #8 is the button
Seat 1: Crisssis (1455)
Seat 2: bisounours25 (2305)
Seat 3: _SmAuG_rAiSe (2760)
Seat 4: sabre_laser (1635)
Seat 5: Maxwell50110 (1430)
Seat 7: Margeurite (1545)
Seat 8: raoulbourvil (1280)
Seat 10: SoMn5mn5 (2590)
*** ANTE/BLINDS ***
SoMn5mn5 posts ante 10
Crisssis posts ante 10
bisounours25 posts ante 10
_SmAuG_rAiSe posts ante 10
sabre_laser posts ante 10
Maxwell50110 posts ante 10
Margeurite posts ante 10
raoulbourvil posts ante 10
SoMn5mn5 posts small blind 100
Crisssis posts big blind 200
Dealt to sabre_laser [4d Kc]
*** PRE-FLOP *** 
bisounours25 folds
_SmAuG_rAiSe raises 300 to 500
sabre_laser folds
Maxwell50110 folds
Margeurite folds
raoulbourvil folds
SoMn5mn5 folds
Crisssis folds
_SmAuG_rAiSe collected 880 from pot
*** SUMMARY ***
Total pot 880 | No rake
Seat 3: _SmAuG_rAiSe won 880


Winamax Poker - Tournament "Double or Nothing" buyIn: 0,46€ + 0,04€ level: 7 - HandId: #540640428702040065-24-1438025027 - Holdem no limit (10/100/200) - 2015/07/27 19:23:47 UTC
Table: 'Double or Nothing(125877659)#0' 10-max (real money) Seat #10 is the button
Seat 1: Crisssis (1245)
Seat 2: bisounours25 (2295)
Seat 3: _SmAuG_rAiSe (3130)
Seat 4: sabre_laser (1625)
Seat 5: Maxwell50110 (1420)
Seat 7: Margeurite (1535)
Seat 8: raoulbourvil (1270)
Seat 10: SoMn5mn5 (2480)
*** ANTE/BLINDS ***
Crisssis posts ante 10
bisounours25 posts ante 10
_SmAuG_rAiSe posts ante 10
sabre_laser posts ante 10
Maxwell50110 posts ante 10
Margeurite posts ante 10
raoulbourvil posts ante 10
SoMn5mn5 posts ante 10
Crisssis posts small blind 100
bisounours25 posts big blind 200
Dealt to sabre_laser [Th 7d]
*** PRE-FLOP *** 
_SmAuG_rAiSe folds
sabre_laser folds
Maxwell50110 folds
Margeurite folds
raoulbourvil folds
SoMn5mn5 folds
Crisssis raises 1035 to 1235 and is all-in
bisounours25 folds
Crisssis collected 1515 from pot
*** SUMMARY ***
Total pot 1515 | No rake
Seat 1: Crisssis (small blind) won 1515


Winamax Poker - Tournament "Double or Nothing" buyIn: 0,46€ + 0,04€ level: 7 - HandId: #540640428702040065-25-1438025060 - Holdem no limit (10/100/200) - 2015/07/27 19:24:20 UTC
Table: 'Double or Nothing(125877659)#0' 10-max (real money) Seat #1 is the button
Seat 1: Crisssis (1515)
Seat 2: bisounours25 (2085)
Seat 3: _SmAuG_rAiSe (3120)
Seat 4: sabre_laser (1615)
Seat 5: Maxwell50110 (1410)
Seat 7: Margeurite (1525)
Seat 8: raoulbourvil (1260)
Seat 10: SoMn5mn5 (2470)
*** ANTE/BLINDS ***
bisounours25 posts ante 10
_SmAuG_rAiSe posts ante 10
Crisssis posts ante 10
sabre_laser posts ante 10
Maxwell50110 posts ante 10
Margeurite posts ante 10
raoulbourvil posts ante 10
SoMn5mn5 posts ante 10
bisounours25 posts small blind 100
_SmAuG_rAiSe posts big blind 200
Dealt to sabre_laser [5d 6s]
*** PRE-FLOP *** 
sabre_laser folds
Maxwell50110 folds
Margeurite folds
raoulbourvil folds
SoMn5mn5 folds
Crisssis folds
bisounours25 folds
_SmAuG_rAiSe collected 380 from pot
*** SUMMARY ***
Total pot 380 | No rake
Seat 3: _SmAuG_rAiSe (big blind) won 380


Winamax Poker - Tournament "Double or Nothing" buyIn: 0,46€ + 0,04€ level: 7 - HandId: #540640428702040065-26-1438025076 - Holdem no limit (10/100/200) - 2015/07/27 19:24:36 UTC
Table: 'Double or Nothing(125877659)#0' 10-max (real money) Seat #2 is the button
Seat 1: Crisssis (1505)
Seat 2: bisounours25 (1975)
Seat 3: _SmAuG_rAiSe (3290)
Seat 4: sabre_laser (1605)
Seat 5: Maxwell50110 (1400)
Seat 7: Margeurite (1515)
Seat 8: raoulbourvil (1250)
Seat 10: SoMn5mn5 (2460)
*** ANTE/BLINDS ***
_SmAuG_rAiSe posts ante 10
sabre_laser posts ante 10
Crisssis posts ante 10
bisounours25 posts ante 10
Maxwell50110 posts ante 10
Margeurite posts ante 10
raoulbourvil posts ante 10
SoMn5mn5 posts ante 10
_SmAuG_rAiSe posts small blind 100
sabre_laser posts big blind 200
Dealt to sabre_laser [Ah Kd]
*** PRE-FLOP *** 
Maxwell50110 folds
Margeurite folds
raoulbourvil folds
SoMn5mn5 folds
Crisssis folds
bisounours25 folds
_SmAuG_rAiSe calls 100
sabre_laser raises 1395 to 1595 and is all-in
_SmAuG_rAiSe folds
sabre_laser collected 1875 from pot
*** SUMMARY ***
Total pot 1875 | No rake
Seat 4: sabre_laser (big blind) won 1875


Winamax Poker - Tournament "Double or Nothing" buyIn: 0,46€ + 0,04€ level: 7 - HandId: #540640428702040065-27-1438025125 - Holdem no limit (10/100/200) - 2015/07/27 19:25:25 UTC
Table: 'Double or Nothing(125877659)#0' 10-max (real money) Seat #3 is the button
Seat 1: Crisssis (1495)
Seat 2: bisounours25 (1965)
Seat 3: _SmAuG_rAiSe (3080)
Seat 4: sabre_laser (1875)
Seat 5: Maxwell50110 (1390)
Seat 7: Margeurite (1505)
Seat 8: raoulbourvil (1240)
Seat 10: SoMn5mn5 (2450)
*** ANTE/BLINDS ***
sabre_laser posts ante 10
Maxwell50110 posts ante 10
Crisssis posts ante 10
bisounours25 posts ante 10
_SmAuG_rAiSe posts ante 10
Margeurite posts ante 10
raoulbourvil posts ante 10
SoMn5mn5 posts ante 10
sabre_laser posts small blind 100
Maxwell50110 posts big blind 200
Dealt to sabre_laser [Jh Ks]
*** PRE-FLOP *** 
Margeurite raises 1295 to 1495 and is all-in
raoulbourvil folds
SoMn5mn5 folds
Crisssis folds
bisounours25 folds
_SmAuG_rAiSe folds
sabre_laser folds
Maxwell50110 folds
Margeurite collected 1875 from pot
*** SUMMARY ***
Total pot 1875 | No rake
Seat 7: Margeurite won 1875


Winamax Poker - Tournament "Double or Nothing" buyIn: 0,46€ + 0,04€ level: 8 - HandId: #540640428702040065-28-1438025149 - Holdem no limit (20/150/300) - 2015/07/27 19:25:49 UTC
Table: 'Double or Nothing(125877659)#0' 10-max (real money) Seat #4 is the button
Seat 1: Crisssis (1485)
Seat 2: bisounours25 (1955)
Seat 3: _SmAuG_rAiSe (3070)
Seat 4: sabre_laser (1765)
Seat 5: Maxwell50110 (1180)
Seat 7: Margeurite (1875)
Seat 8: raoulbourvil (1230)
Seat 10: SoMn5mn5 (2440)
*** ANTE/BLINDS ***
Maxwell50110 posts ante 20
Margeurite posts ante 20
Crisssis posts ante 20
bisounours25 posts ante 20
_SmAuG_rAiSe posts ante 20
sabre_laser posts ante 20
raoulbourvil posts ante 20
SoMn5mn5 posts ante 20
Maxwell50110 posts small blind 150
Margeurite posts big blind 300
Dealt to sabre_laser [7h Jd]
*** PRE-FLOP *** 
raoulbourvil folds
SoMn5mn5 folds
Crisssis folds
bisounours25 folds
_SmAuG_rAiSe raises 450 to 750
sabre_laser folds
Maxwell50110 folds
Margeurite folds
_SmAuG_rAiSe collected 1360 from pot
*** SUMMARY ***
Total pot 1360 | No rake
Seat 3: _SmAuG_rAiSe won 1360


Winamax Poker - Tournament "Double or Nothing" buyIn: 0,46€ + 0,04€ level: 8 - HandId: #540640428702040065-29-1438025175 - Holdem no limit (20/150/300) - 2015/07/27 19:26:15 UTC
Table: 'Double or Nothing(125877659)#0' 10-max (real money) Seat #5 is the button
Seat 1: Crisssis (1465)
Seat 2: bisounours25 (1935)
Seat 3: _SmAuG_rAiSe (3660)
Seat 4: sabre_laser (1745)
Seat 5: Maxwell50110 (1010)
Seat 7: Margeurite (1555)
Seat 8: raoulbourvil (1210)
Seat 10: SoMn5mn5 (2420)
*** ANTE/BLINDS ***
Margeurite posts ante 20
raoulbourvil posts ante 20
Crisssis posts ante 20
bisounours25 posts ante 20
_SmAuG_rAiSe posts ante 20
sabre_laser posts ante 20
Maxwell50110 posts ante 20
SoMn5mn5 posts ante 20
Margeurite posts small blind 150
raoulbourvil posts big blind 300
Dealt to sabre_laser [Kh Ah]
*** PRE-FLOP *** 
SoMn5mn5 folds
Crisssis folds
bisounours25 folds
_SmAuG_rAiSe folds
sabre_laser raises 450 to 750
Maxwell50110 folds
Margeurite folds
raoulbourvil raises 440 to 1190 and is all-in
sabre_laser calls 440
*** FLOP *** [9s 7s 5s]
*** TURN *** [9s 7s 5s][3s]
*** RIVER *** [9s 7s 5s 3s][3h]
*** SHOW DOWN ***
sabre_laser shows [Kh Ah] (One pair : 3)
raoulbourvil shows [Ad Ts] (Flush Ten high)
raoulbourvil collected 2690 from pot
*** SUMMARY ***
Total pot 2690 | No rake
Board: [9s 7s 5s 3s 3h]
Seat 4: sabre_laser showed [Kh Ah] and lost with One pair : 3
Seat 8: raoulbourvil (big blind) showed [Ad Ts] and won 2690 with Flush Ten high


Winamax Poker - Tournament "Double or Nothing" buyIn: 0,46€ + 0,04€ level: 8 - HandId: #540640428702040065-30-1438025233 - Holdem no limit (20/150/300) - 2015/07/27 19:27:13 UTC
Table: 'Double or Nothing(125877659)#0' 10-max (real money) Seat #7 is the button
Seat 1: Crisssis (1445)
Seat 2: bisounours25 (1915)
Seat 3: _SmAuG_rAiSe (3640)
Seat 4: sabre_laser (535)
Seat 5: Maxwell50110 (990)
Seat 7: Margeurite (1385)
Seat 8: raoulbourvil (2690)
Seat 10: SoMn5mn5 (2400)
*** ANTE/BLINDS ***
raoulbourvil posts ante 20
SoMn5mn5 posts ante 20
Crisssis posts ante 20
bisounours25 posts ante 20
_SmAuG_rAiSe posts ante 20
sabre_laser posts ante 20
Maxwell50110 posts ante 20
Margeurite posts ante 20
raoulbourvil posts small blind 150
SoMn5mn5 posts big blind 300
Dealt to sabre_laser [6d 3s]
*** PRE-FLOP *** 
Crisssis folds
bisounours25 folds
_SmAuG_rAiSe folds
sabre_laser folds
Maxwell50110 raises 670 to 970 and is all-in
Margeurite folds
raoulbourvil folds
SoMn5mn5 calls 670
*** FLOP *** [5d Qd Ah]
*** TURN *** [5d Qd Ah][2s]
*** RIVER *** [5d Qd Ah 2s][Tc]
*** SHOW DOWN ***
Maxwell50110 shows [2d 5c] (Two pairs : 5 and 2)
SoMn5mn5 shows [Qh Qc] (Trips of Queens)
SoMn5mn5 collected 2250 from pot
*** SUMMARY ***
Total pot 2250 | No rake
Board: [5d Qd Ah 2s Tc]
Seat 5: Maxwell50110 showed [2d 5c] and lost with Two pairs : 5 and 2
Seat 10: SoMn5mn5 (big blind) showed [Qh Qc] and won 2250 with Trips of Queens


Winamax Poker - Tournament "Double or Nothing" buyIn: 0,46€ + 0,04€ level: 8 - HandId: #540640428702040065-31-1438025281 - Holdem no limit (20/150/300) - 2015/07/27 19:28:01 UTC
Table: 'Double or Nothing(125877659)#0' 10-max (real money) Seat #8 is the button
Seat 1: Crisssis (1425)
Seat 2: bisounours25 (1895)
Seat 3: _SmAuG_rAiSe (3620)
Seat 4: sabre_laser (515)
Seat 7: Margeurite (1365)
Seat 8: raoulbourvil (2520)
Seat 10: SoMn5mn5 (3660)
*** ANTE/BLINDS ***
SoMn5mn5 posts ante 20
Crisssis posts ante 20
bisounours25 posts ante 20
_SmAuG_rAiSe posts ante 20
sabre_laser posts ante 20
Margeurite posts ante 20
raoulbourvil posts ante 20
SoMn5mn5 posts small blind 150
Crisssis posts big blind 300
Dealt to sabre_laser [5c 5s]
*** PRE-FLOP *** 
bisounours25 folds
_SmAuG_rAiSe calls 300
sabre_laser raises 195 to 495 and is all-in
Margeurite folds
raoulbourvil folds
SoMn5mn5 folds
Crisssis calls 195
_SmAuG_rAiSe calls 195
*** FLOP *** [4s Kd Jd]
Crisssis checks
_SmAuG_rAiSe checks
*** TURN *** [4s Kd Jd][7d]
Crisssis bets 910 and is all-in
_SmAuG_rAiSe calls 910
*** RIVER *** [4s Kd Jd 7d][Th]
*** SHOW DOWN ***
Crisssis shows [Td Kc] (Two pairs : Kings and Tens)
sabre_laser shows [5c 5s] (One pair : 5)
_SmAuG_rAiSe shows [Kh Ks] (Trips of Kings)
_SmAuG_rAiSe collected 3595 from pot
*** SUMMARY ***
Total pot 3595 | No rake
Board: [4s Kd Jd 7d Th]
Seat 1: Crisssis (big blind) showed [Td Kc] and lost with Two pairs : Kings and Tens
Seat 3: _SmAuG_rAiSe showed [Kh Ks] and won 3595 with Trips of Kings
Seat 4: sabre_laser showed [5c 5s] and lost with One pair : 5


